#English_unigrams	German_translation	#label
Hun_noun	Inselaffe_noun	DEROGATORY
Jap_noun	Japse_noun	DEROGATORY
Jihadi_noun	?	DEROGATORY
Yardie_noun	?	DEROGATORY
abasement_noun	Demütigung_noun	OTHER
abhor_verb	verabscheuen_verb	DEROGATORY
abjure_verb	entsagen_verb	OTHER
abolish_verb	abschaffen_verb	OTHER
abominable_adj	abscheulig_adj	DEROGATORY
abomination_noun	Abscheulichkeit_noun	DEROGATORY
abscond_verb	entfliehen_verb	OTHER
absence_noun	Abwesenheit_noun	OTHER
absurdity_noun	Unding_noun	OTHER
abuse_noun	Misshandlung_noun	OTHER
abuse_verb	misshandeln_verb	OTHER
abusive_adj	ausfällig_adj	DEROGATORY
accost_verb	anpöbeln_verb	OTHER
accuse_verb	beschuldigen_verb	OTHER
addiction_noun	Suche_noun	OTHER
admonishment_noun	Mahnung_noun	OTHER
admonition_noun	Ermahnung_noun	OTHER
adulteration_noun	Verfälschung_noun	OTHER
adverse_adj	widrig_adj	OTHER
adversity_noun	Widrigkeit_noun	OTHER
affectation_noun	Affektiertheit_noun	OTHER
afflict_verb	heimsuchen_verb	OTHER
affront_noun	Affront_noun	DEROGATORY
affront_verb	kränken_verb	OTHER
afraid_adj	besorgt_adj	OTHER
aggravation_noun	Verschärfung_noun	OTHER
aggression_noun	Aggression_noun	OTHER
aggressor_noun	Aggressor_noun	OTHER
agitate_verb	hetzen_verb	OTHER
agitation_noun	Hetze_noun	OTHER
agitator_noun	Hetzer_noun	DEROGATORY
agonize_verb	quälen_verb	OTHER
agonizing_adj	quälend_adj	OTHER
ail_verb	wehtun_verb	OTHER
aimless_adj	ziellos_adj	OTHER
alarm_verb	alarmieren_verb	OTHER
alarming_adj	alarmierend_adj	OTHER
alienate_verb	entfremden_verb	OTHER
alienated_adj	entfremdet_adj	OTHER
alienation_noun	Entfremdung_noun	OTHER
allegation_noun	Vorwurf_noun	OTHER
aloof_adj	abgehoben_adj	DEROGATORY
ambiguity_noun	Mehrdeutigkeit_noun	OTHER
ambush_noun	Hinterhalt_noun	DEROGATORY
ambush_verb	auflauern_verb	OTHER
anarchist_noun	Anarchist_noun	DEROGATORY
anemic_adj	kraftlos_adj	OTHER
anger_noun	Ärger_noun	OTHER
angry_adj	verägert_adj	OTHER
animosity_noun	Feindseligkeit_noun	OTHER
annihilate_verb	ausmerzen_verb	DEROGATORY
annoyance_noun	Verärgerung_noun	OTHER
anomaly_noun	Anomalie_noun	OTHER
antagonism_noun	Antagonismus_noun	OTHER
antagonistic_adj	antagonistisch_adj	OTHER
antithetical_adj	antithetisch_adj	OTHER
anxiety_noun	Angst_noun	OTHER
anxiousness_noun	Ängstlichkeit_noun	OTHER
ape_verb	nachäffen_verb	OTHER
appal_verb	entsetzen_verb	OTHER
appalled_adj	entsetzt_adj	DEROGATORY
apprehension_noun	Festnahme_noun	OTHER
arcane_adj	geheimnisvoll_adj	OTHER
archaic_adj	archaisch_adj	OTHER
arrogance_noun	Arroganz_noun	DEROGATORY
arrogant_adj	arrogant_adj	DEROGATORY
arse_noun	Arsch_noun	DEROGATORY
ashamed_adj	beschämt_adj	DEROGATORY
asinine_adj	idiotisch_adj	DEROGATORY
aspersion_noun	?	OTHER
ass_noun	Dummkopf_noun	DEROGATORY
assassinate_verb	meucheln_verb	DEROGATORY
assault_noun	Überfall_noun	DEROGATORY
asshole_noun	Arschloch_noun	DEROGATORY
atrocity_noun	Gräuel_noun	DEROGATORY
attack_noun	Angriff_noun	OTHER
attack_verb	herfallen_verb	DEROGATORY
audaciousness_noun	Kühnheit_noun	OTHER
audacity_noun	Verwegenheit_noun	OTHER
austere_adj	streng_adj	OTHER
authoritarian_adj	autoritär_adj	OTHER
avarice_noun	Habgier_noun	DEROGATORY
avaricious_adj	habgierig_adj	DEROGATORY
aversion_noun	Abneigung_noun	OTHER
avoid_verb	vermeiden_verb	OTHER
avoidance_noun	Vermeidung_noun	OTHER
awful_adj	fürchterlich_adj	DEROGATORY
awfulness_noun	Schrecklichkeit_noun	DEROGATORY
awkward_adj	linkisch_adj	DEROGATORY
ax_verb	beschneiden_verb	OTHER
backbiting_noun	Verleumdung_noun	DEROGATORY
backward_adj	zurückgeblieben_adj	DEROGATORY
bad_adj	schlecht_adj	OTHER
bait_verb	ködern_verb	OTHER
balk_verb	scheuen_verb	OTHER
bampot_noun	Dumpfbacke_noun	DEROGATORY
banal_adj	banal_adj	OTHER
bankrupt_verb	bankrottgehen_verb	OTHER
bar_verb	versperren_verb	OTHER
barbaric_adj	barbarisch_adj	DEROGATORY
barbarous_adj	ungesittet_adj	DEROGATORY
barren_adj	kahl_adj	OTHER
bastard_noun	Bastard_noun	DEROGATORY
battle_verb	bekämpfen_verb	OTHER
battleground_noun	Schlachtfeld_noun	OTHER
beaner_noun	Bohnenfresser_noun	DEROGATORY
beast_noun	Bestie_noun	DEROGATORY
beastly_adj	saumäßig_adj	DEROGATORY
beg_verb	betteln_verb	OTHER
beguile_verb	betören_verb	OTHER
belittle_verb	schlechtmachen_verb	DEROGATORY
bellicose_adj	kriegerisch_adj	OTHER
belligerence_noun	Kriegslust_noun	OTHER
bemoan_verb	beklagen_verb	OTHER
berate_verb	schelten_verb	OTHER
besiege_verb	bedrängen_verb	OTHER
bestial_adj	bestialisch_adj	DEROGATORY
betray_verb	verraten_verb	OTHER
betrayer_noun	Verräter_noun	DEROGATORY
bewail_verb	klagen_verb	OTHER
bewilder_verb	verwirren_verb	OTHER
bewildering_adj	verwirrend_adj	OTHER
bewilderment_noun	Verwirrung_noun	OTHER
bicker_verb	zanken_verb	OTHER
bickering_noun	Gezänk_noun	OTHER
bint_noun	Tuse_noun	DEROGATORY
bitch_noun	Zicke_noun	DEROGATORY
biting_adj	bissig_adj	OTHER
bitter_adj	hämisch_adj	DEROGATORY
blab_verb	plappern_verb	DEROGATORY
blabber_verb	labern_verb	DEROGATORY
blame_noun	Tadel_noun	OTHER
blame_verb	beschuldigen_verb	OTHER
blaspheme_verb	lästern_verb	DEROGATORY
blasphemy_noun	Blasphemie_noun	DEROGATORY
blast_verb	absprengen_verb	OTHER
blasted_adj	öde_adj	OTHER
blather_verb	schwafeln_verb	DEROGATORY
blemish_noun	Makel_noun	OTHER
blemish_verb	verunstalten_verb	OTHER
blind_adj	blind_adj	DEROGATORY
blind_verb	blenden_verb	OTHER
blinding_adj	blendend_adj	OTHER
blindside_verb	überrumpeln_verb	OTHER
bloodthirsty_adj	blutrünstig_adj	DEROGATORY
blunt_adj	unverblümt_adj	OTHER
blur_verb	trüben_verb	OTHER
bogan_noun	Prolet_noun	DEROGATORY
boggle_verb	stutzen_verb	OTHER
bogus_adj	betrügerisch_adj	DEROGATORY
bollocks_noun	Schwachsinn_noun	DEROGATORY
bombard_verb	bombardieren_verb	OTHER
bombardment_noun	Beschuss_noun	DEROGATORY
bondage_noun	Gefangenschaft_noun	OTHER
boner_noun	Latte_noun	DEROGATORY
bore_verb	langeweilen_verb	OTHER
boredom_noun	Langeweile_noun	OTHER
botch_verb	pfuschen_verb	DEROGATORY
bother_verb	nerven_verb	OTHER
boycott_noun	Boykott_noun	OTHER
braggart_noun	Angeber_noun	DEROGATORY
brainwash_verb	?	OTHER
bravado_noun	Angeberei_noun	DEROGATORY
brazenness_noun	?	OTHER
breach_noun	Bruch_noun	OTHER
break_verb	brechen_verb	OTHER
bristle_verb	sträuben_verb	OTHER
broke_adj	pleite_adj	OTHER
brood_verb	grübeln_verb	OTHER
brutality_noun	Brutalität_noun	DEROGATORY
brutalize_verb	brutalisieren_verb	OTHER
brute_noun	Wüstling_noun	DEROGATORY
buckra_noun	Weißer_noun	DEROGATORY
bug_verb	stören_verb	OTHER
bugger_noun	Flegel_noun	DEROGATORY
bullshit_noun	Scheiße_noun	DEROGATORY
bully_noun	Rüpel_noun	DEROGATORY
bungle_verb	verbocken_verb	OTHER
bungler_noun	Stümper_noun	DEROGATORY
burdensome_adj	lästig_adj	DEROGATORY
burrhead_noun	?	DEROGATORY
busy_adj	ausgelastet_adj	OTHER
butchery_noun	Gemetzel_noun	DEROGATORY
cackle_verb	gackern_verb	OTHER
cajole_verb	beschwatzen_verb	OTHER
cancer_noun	Geschwür_noun	DEROGATORY
cancerous_adj	krebsartig_adj	DEROGATORY
cannibalize_verb	filletieren_verb	DEROGATORY
capricious_adj	launisch_adj	DEROGATORY
capriciousness_noun	Launenhaftigkeit_noun	DEROGATORY
careless_adj	leichtsinnig_adj	DEROGATORY
carelessness_noun	Leichtsinn_noun	DEROGATORY
caricature_verb	karikieren_verb	OTHER
carnage_noun	Blutbad_noun	DEROGATORY
carp_verb	nörgeln_verb	OTHER
cartoon_noun	Karikatur_noun	OTHER
cash-strapped_adj	klamm_adj	OTHER
castigate_verb	geißeln_verb	OTHER
catastrophe_noun	Katastrophe_noun	OTHER
cautious_adj	zurückhaltend_adj	OTHER
celesbian_noun	?	DEROGATORY
censure_verb	zensieren_verb	OTHER
chafe_verb	scheuern_verb	OTHER
challenge_verb	herausfordern_verb	OTHER
chaos_noun	Chaos_noun	OTHER
charva_noun	?	DEROGATORY
charver_noun	?	DEROGATORY
chasten_verb	demütigen_verb	OTHER
chatter_verb	schnattern_verb	OTHER
chatterbox_noun	Quasselstrippe_noun	OTHER
chav_noun	Proll_noun	DEROGATORY
cheapen_verb	verbilligen_verb	OTHER
cheat_noun	Betrüger_noun	DEROGATORY
cheat_verb	betrügen_verb	DEROGATORY
cheerless_adj	trübselig_adj	OTHER
chide_verb	tadeln_verb	OTHER
chill_verb	abkühlen_verb	OTHER
choke_verb	ersticken_verb	OTHER
chonky_noun	?	DEROGATORY
chug_noun	?	DEROGATORY
clamor_noun	Gezeter_noun	OTHER
cliche_noun	Klischee_noun	DEROGATORY
clog_verb	verstopfen_verb	OTHER
close_adj	gedrängt_adj	OTHER
clumsy_adj	tollpatschig_adj	DEROGATORY
cock_noun	Nille_noun	DEROGATORY
cocky_adj	rotzfrech_adj	DEROGATORY
coerce_verb	nötigen_verb	OTHER
coercion_noun	Nötigung_noun	OTHER
cold_adj	gefühlskalt_adj	DEROGATORY
collapse_verb	zusammenbrechen_verb	OTHER
collide_verb	aufeinanderprallen_verb	OTHER
collusion_noun	Kollusion_noun	OTHER
combative_adj	streitlustig_adj	OTHER
comical_adj	komisch_adj	OTHER
commiserate_verb	bemitleiden_verb	OTHER
compel_verb	zwingen_verb	OTHER
complacent_adj	selbstgefällig_adj	DEROGATORY
compulsion_noun	Zwang_noun	OTHER
compulsive_adj	zwanghaft_adj	OTHER
conceit_noun	Einbildung_noun	OTHER
conceited_adj	eingebildet_adj	DEROGATORY
concern_noun	Bedenken_noun	OTHER
concern_verb	beunruhigen_verb	OTHER
concession_noun	Zugeständnis_noun	OTHER
condemn_verb	verurteilen_verb	OTHER
condescend_verb	herablassen_verb	OTHER
condescension_noun	Herablassung_noun	OTHER
condolence_noun	Anteilnahme_noun	OTHER
confound_verb	vereiteln_verb	OTHER
confront_verb	konfrontieren_verb	OTHER
confrontation_noun	Konfrontation_noun	OTHER
confrontational_adj	streitlustig_adj	OTHER
confuse_verb	irritieren_verb	OTHER
confused_adj	irritiert_adj	OTHER
congested_adj	verstopft_adj	OTHER
conspicuous_adj	auffallend_adj	OTHER
conspire_verb	verschwören_verb	OTHER
consternation_noun	Fassungslosigkeit_noun	OTHER
constraint_noun	Einschränkung_noun	OTHER
contempt_noun	Verachtung_noun	DEROGATORY
contend_verb	streiten_verb	OTHER
contention_noun	Auseinandersetzung_noun	OTHER
contort_verb	verzerren_verb	OTHER
contradict_verb	widersprechen_verb	OTHER
contrariness_noun	Widersprüchlichkeit_noun	OTHER
contravene_verb	zuwiderhandeln_verb	OTHER
contrive_verb	aushecken_verb	OTHER
coolie_noun	Kuli_noun	DEROGATORY
coon_noun	Neger_noun	DEROGATORY
cooter_noun	Pflaume?_noun	DEROGATORY
corrode_verb	verrosten_verb	OTHER
corrosive_adj	ätzend_adj	DEROGATORY
corrupt_verb	korrumpieren_verb	OTHER
counterproductive_adj	kontraproduktiv_adj	OTHER
cow_verb	entmutigen_verb	OTHER
cracker_noun	?	DEROGATORY
cramped_adj	eingeengt_adj	OTHER
crap_noun	Schrott_noun	DEROGATORY
crass_adj	strohdumm_adj	DEROGATORY
craze_noun	Fimmel_noun	OTHER
craziness_noun	Verrücktheit_noun	DEROGATORY
crime_noun	Verbrechen_noun	OTHER
cringe_verb	kriechen_verb	DEROGATORY
cripple_noun	Krüppel_noun	DEROGATORY
cripple_verb	verkrüppeln_verb	DEROGATORY
critical_adj	kritisch_adj	OTHER
criticize_verb	kritisieren_verb	OTHER
cross_adj	ärgerlich_adj	OTHER
crude_adj	unbeholfen_adj	DEROGATORY
cruel_adj	grausam_adj	DEROGATORY
crumble_verb	bröckeln_verb	OTHER
crumple_verb	zerknittern_verb	OTHER
crush_verb	zerdrücken_verb	OTHER
crushing_adj	erdrückend_adj	OTHER
cuck_noun	Cuck_noun	DEROGATORY
cunt_noun	Fotze_noun	DEROGATORY
curse_verb	verfluchen_verb	DEROGATORY
cursed_adj	verflucht_adj	DEROGATORY
cuss_verb	verwünschen_verb	OTHER
cutthroat_adj	halsabschneiderisch_adj	OTHER
cynicism_noun	Zynismus_noun	OTHER
dago_noun	Kanake_noun	DEROGATORY
damage_noun	Schaden_noun	OTHER
damage_verb	schaden_verb	OTHER
damn_verb	verdammen_verb	DEROGATORY
damnable_adj	verdammenswert_adj	OTHER
danger_noun	Gefahr_noun	OTHER
dangle_verb	wackeln_verb	OTHER
darken_verb	verdunkeln_verb	OTHER
darkey_noun	Bimbo_noun	DEROGATORY
darkie_noun	Bimbo_noun	DEROGATORY
dawdle_verb	vertrödeln_verb	DEROGATORY
dazed_adj	benommen_adj	OTHER
deadlock_noun	Stillstand_noun	OTHER
deadly_adj	tödlich_adj	OTHER
dearth_noun	Mangel_noun	OTHER
death_noun	Tod_noun	OTHER
debacle_noun	Debakel_noun	OTHER
debate_verb	debattieren_verb	OTHER
debaucher_noun	Verführer_noun	OTHER
debauchery_noun	Prasserei_noun	DEROGATORY
debilitate_verb	entkräften_verb	OTHER
debility_noun	Kraftlosigkeit_noun	OTHER
decadent_adj	dekadent_adj	OTHER
deceitful_adj	hinterlistig_adj	DEROGATORY
deceive_verb	täuschen_verb	OTHER
decline_noun	Verfall_noun	OTHER
decrease_noun	Abnahme_noun	OTHER
decrease_verb	schwinden_verb	OTHER
decrepit_adj	hinfällig_adj	OTHER
decrepitude_noun	Hinfälligkeit_noun	OTHER
decry_verb	anprangern_verb	OTHER
defeat_noun	Niederlage_noun	OTHER
defeat_verb	bezwingen_verb	OTHER
defiance_noun	Trotz_noun	OTHER
deficiency_noun	Unzulänglichkeit_noun	OTHER
deform_verb	verformen_verb	OTHER
defy_verb	trotzen_verb	OTHER
degenerate_verb	degenerieren_verb	OTHER
degeneration_noun	Degeneration_noun	OTHER
degrade_verb	entarten_verb	OTHER
deign_verb	geruhen_verb	OTHER
dejection_noun	Schwermut_noun	OTHER
delinquent_adj	delinquent_adj	DEROGATORY
delirium_noun	Fieberwahn_noun	OTHER
delude_verb	vormachen_verb	OTHER
deluded_adj	verblendet_adj	DEROGATORY
deluge_noun	Sintflut_noun	OTHER
demean_verb	erniedrigen_verb	DEROGATORY
demise_noun	Niedergang_noun	OTHER
demonize_verb	verteufeln_verb	DEROGATORY
demoralize_verb	demoralisieren_verb	OTHER
denigrate_verb	anschwärzen_verb	DEROGATORY
denounce_verb	anprangern_verb	OTHER
deprecate_verb	missbilligen_verb	OTHER
depress_verb	deprimieren_verb	OTHER
depression_noun	Depression_noun	OTHER
despair_noun	Hoffnungslosigkeit_noun	OTHER
despair_verb	verzweifeln_verb	OTHER
desperate_adj	verzweifelt_adj	OTHER
desperation_noun	Verzweiflung_noun	OTHER
despondency_noun	Mutlosigkeit_noun	OTHER
despondent_adj	niedergeschlagen_adj	OTHER
despotic_adj	despotisch_adj	DEROGATORY
despotism_noun	Willkürherrschaft_noun	DEROGATORY
destabilisation_noun	Destabilisierung_noun	OTHER
destitute_adj	mittellos_adj	OTHER
destitution_noun	Mittellosigkeit_noun	OTHER
destroy_verb	zerstören_verb	DEROGATORY
destroyer_noun	Zerstörer_noun	OTHER
destructive_adj	vernichtend_adj	DEROGATORY
deterrent_noun	Abschreckungsmittel_noun	OTHER
detest_verb	verabscheuen_verb	DEROGATORY
detestable_adj	abscheulich_adj	DEROGATORY
devastate_verb	verwüsten_verb	OTHER
devastated_adj	verwüstet_adj	OTHER
devil_noun	Teufel_noun	DEROGATORY
devilment_noun	Schelmerei_noun	OTHER
devilry_noun	Teufelei_noun	OTHER
dhimmi_noun	?	DEROGATORY
diabolic_adj	teuflisch_adj	DEROGATORY
diatribe_noun	Schmährede_noun	DEROGATORY
dick_noun	Schwanz_noun	DEROGATORY
dictatorial_adj	diktatorisch_adj	DEROGATORY
differ_verb	abweichen_verb	OTHER
diffidence_noun	Zaghaftigkeit_noun	OTHER
dig_verb	schubsen_verb	OTHER
dilly-dally_verb	bummeln_verb	OTHER
dim_verb	abblenden_verb	OTHER
diminish_verb	verringern_verb	OTHER
dinge_noun	Nigger_noun	DEROGATORY
dink_noun	Dink_noun	DEROGATORY
dirt_noun	Schmutz_noun	OTHER
disable_verb	unterbinden_verb	OTHER
disabled_adj	behindert_adj	OTHER
disadvantage_noun	Nachteil_noun	OTHER
disaffected_adj	abgeneigt_adj	OTHER
disagreeable_adj	unliebsam_adj	OTHER
disagreement_noun	Meinungsverschiedenheit_noun	OTHER
disallow_verb	verweigern_verb	OTHER
disapprove_verb	missbilligen_verb	OTHER
disapproving_adj	missbilligend_adj	OTHER
disarm_verb	entwaffnen_verb	OTHER
disastrous_adj	desaströs_adj	OTHER
disavow_verb	ableugnen_verb	OTHER
disavowal_noun	Verleugnung_noun	OTHER
disbelieve_verb	bezweifeln_verb	OTHER
disbeliever_noun	Ungläubiger_noun	DEROGATORY
discomfit_verb	verunsichern_verb	OTHER
disconcert_verb	verdutzen_verb	OTHER
disconcerted_adj	verdutzt_adj	OTHER
disconsolate_adj	untröstlich_adj	OTHER
discontent_noun	Unzufriedenheit_noun	OTHER
discontented_adj	unzufrieden_adj	OTHER
discord_noun	Zwietracht_noun	OTHER
discordance_noun	Uneinigkeit_noun	OTHER
discourage_verb	abraten_verb	OTHER
discouragement_noun	Entmutigung_noun	OTHER
discouraging_adj	?	DEROGATORY
discredit_verb	diskreditieren_verb	OTHER
discriminate_verb	diskriminieren_verb	OTHER
discrimination_noun	Diskriminierung_noun	OTHER
disdainful_adj	verächtlich_adj	DEROGATORY
disgraceful_adj	schändlich_adj	DEROGATORY
disgruntled_adj	missvergnügt_adj	OTHER
disgust_noun	Ekel_noun	OTHER
disgust_verb	abstoßen_verb	DEROGATORY
disgusted_adj	angewidert_adj	DEROGATORY
dishonest_adj	verlogen_adj	DEROGATORY
dishonesty_noun	Verlogenheit_noun	DEROGATORY
dishonor_verb	entehren_verb	DEROGATORY
disillusion_noun	Ernüchterung_noun	DEROGATORY
disillusion_verb	ernüchtern_verb	OTHER
disillusioned_adj	ernüchternd_adj	OTHER
disinclination_noun	Abneigung_noun	OTHER
disintegrate_verb	?	DEROGATORY
disintegration_noun	Zersetzung_noun	OTHER
disinterest_noun	Desinteresse_noun	OTHER
disloyalty_noun	Untreue_noun	DEROGATORY
dismal_adj	erbärmlich_adj	DEROGATORY
dismay_verb	bestürzen_verb	OTHER
disown_verb	enteignen_verb	OTHER
disparage_verb	herabsetzen_verb	OTHER
dispensable_adj	entbehrlich_adj	OTHER
dispirited_adj	niedergeschlagen_adj	OTHER
dispiriting_adj	entmutigend_adj	OTHER
displeasure_noun	Verdruss_noun	OTHER
dispute_verb	anfechten_verb	OTHER
disputed_adj	angefochten_adj	OTHER
disquieting_adj	ungut_adj	OTHER
disrespect_verb	geringschätzen_verb	DEROGATORY
disrespectful_adj	respektlos_adj	DEROGATORY
disrupt_verb	spalten_verb	OTHER
disruptive_adj	spaltend_adj	OTHER
dissatisfaction_noun	Missfallen_noun	OTHER
dissatisfied_adj	frustriert_adj	OTHER
dissemble_verb	verbergen_verb	OTHER
dissent_noun	Dissens_noun	OTHER
dissenter_noun	Dissident_noun	OTHER
dissolution_noun	Auflösung_noun	OTHER
dissonance_noun	Dissonanz_noun	OTHER
distasteful_adj	widerlich_adj	DEROGATORY
distort_verb	verzerren_verb	OTHER
distortion_noun	Verzerrung_noun	OTHER
distract_verb	ablenken_verb	OTHER
distraction_noun	Ablenkung_noun	OTHER
distress_verb	dedrücken_verb	OTHER
distressing_adj	betrüblich_adj	OTHER
distrust_verb	misstrauen_verb	OTHER
disturb_verb	stören_verb	OTHER
disturbing_adj	störend_adj	OTHER
div_noun	Tollpatsch_noun	DEROGATORY
divide_verb	teilen_verb	OTHER
divided_adj	gespalten_adj	OTHER
division_noun	Spaltung_noun	OTHER
divisive_adj	entzweiend_adj	OTHER
divisiveness_noun	Entzweiung_noun	OTHER
divorce_noun	Scheidung_noun	OTHER
doddering_adj	schlotternd_adj	OTHER
dominance_noun	Dominanz_noun	OTHER
dominate_verb	dominieren_verb	OTHER
domination_noun	Herrschaft_noun	OTHER
doubt_noun	Zweifel_noun	OTHER
douchbag_noun	Schlappschwanz_noun	DEROGATORY
downfall_noun	Untergang_noun	OTHER
downgrade_verb	herunterstufen_verb	OTHER
downhearted_adj	entmutigt_adj	OTHER
dragon_noun	Drache_noun	DEROGATORY
drain_noun	?	DEROGATORY
dread_noun	Furcht_noun	OTHER
drought_noun	Dürre_noun	OTHER
dubious_adj	zwielichtig_adj	DEROGATORY
dud_noun	Lusche_noun	DEROGATORY
dullard_noun	Dummerchen_noun	DEROGATORY
dumb_adj	dumm_adj	DEROGATORY
dumbass_noun	Vollpfosten_noun	DEROGATORY
dummy_noun	Doofi_noun	DEROGATORY
dump_noun	Müllkippe_noun	OTHER
dunce_noun	Schwachkopf_noun	DEROGATORY
dupe_verb	übertölpeln_verb	DEROGATORY
dusty_adj	verstaubt_adj	OTHER
dyke_noun	Lesbe_noun	DEROGATORY
earsplitting_adj	ohrenbetäubend_adj	DEROGATORY
eccentricity_noun	Exzentrizität_noun	OTHER
effrontery_noun	Frechheit_noun	DEROGATORY
ego_noun	Selbstgefühl_noun	OTHER
egomania_noun	Egomanie_noun	DEROGATORY
egotism_noun	Egoismus_noun	DEROGATORY
egotistical_adj	egoistisch_adj	DEROGATORY
ejaculate_verb	ejakulieren_verb	OTHER
eliminate_verb	vernichten_verb	OTHER
elimination_noun	Vernichtung_noun	OTHER
emasculate_verb	entmannen_verb	OTHER
embarrassing_adj	peinlich_adj	DEROGATORY
embarrassment_noun	Peinlichkeit_noun	DEROGATORY
embattled_adj	umkämpft_adj	OTHER
empathy_noun	Mitgefühl_noun	OTHER
encroachment_noun	Übergriff_noun	OTHER
endanger_verb	gefährden_verb	OTHER
enemy_noun	Feind_noun	OTHER
engulf_verb	verschlingen_verb	OTHER
enrage_verb	erzürnen_verb	OTHER
enraged_adj	erzürnt_adj	OTHER
enslave_verb	versklaven_verb	DEROGATORY
entangle_verb	verfangen_verb	OTHER
entanglement_noun	Gewirr_noun	OTHER
entrap_verb	verstricken_verb	OTHER
envious_adj	neidisch_adj	DEROGATORY
envy_noun	Neid_noun	DEROGATORY
envy_verb	beneiden_verb	DEROGATORY
epidemic_adj	epidemisch_adj	OTHER
equivocal_adj	fragwürdig_adj	OTHER
eradicate_verb	beseitigen_verb	OTHER
erase_verb	ausradieren_verb	OTHER
err_verb	irren_verb	OTHER
errant_adj	fehlgeleitet_adj	OTHER
error_noun	Fehler_noun	OTHER
estranged_adj	entfremdet_adj	OTHER
evasion_noun	Ausflucht_noun	OTHER
evil_adj	böse_adj	DEROGATORY
evildoer_noun	Übeltäter_noun	DEROGATORY
eviscerate_verb	?	DEROGATORY
exacerbate_verb	erschweren_verb	OTHER
exacting_adj	anspruchsvoll_adj	OTHER
exaggerate_verb	übertreiben_verb	OTHER
exasperate_verb	verschlimmern_verb	OTHER
excessive_adj	exzessiv_adj	OTHER
exclude_verb	ausschließen_verb	OTHER
excuse_noun	Entschuldigung_noun	OTHER
excuse_verb	entschuldigen_verb	OTHER
exhaust_verb	erschöpfen_verb	OTHER
exile_verb	verbannen_verb	OTHER
expel_verb	vertreiben_verb	OTHER
exploitation_noun	Ausbeuterei_noun	DEROGATORY
explosive_adj	explosiv_adj	OTHER
exterminate_verb	ausrotten_verb	DEROGATORY
extreme_adj	extrem_adj	OTHER
extremism_noun	Extremismus_noun	OTHER
eyetie_noun	Spaghettifresser_noun	DEROGATORY
fabricate_verb	fälschen_verb	DEROGATORY
fag_noun	Tunte_noun	DEROGATORY
faggot_noun	Schwuchtel_noun	DEROGATORY
fail_verb	versagen_verb	DEROGATORY
fall_verb	fallen_verb	OTHER
false_adj	falsch_adj	OTHER
falter_verb	schwanken_verb	OTHER
famine_noun	Hungersnot_noun	OTHER
famished_adj	ausgehungert_adj	OTHER
fanatical_adj	fanatisch_adj	OTHER
fanny_noun	Möse_noun	DEROGATORY
fart_noun	Furz_noun	DEROGATORY
fart_verb	furzen_verb	DEROGATORY
fascism_noun	Faschismus_noun	OTHER
fatalistic_adj	fatalistic_adj	DEROGATORY
fault_verb	bemängeln_verb	OTHER
faulty_adj	fehlerhaft_adj	OTHER
fear_verb	fürchten_verb	OTHER
feeble_adj	kläglich_adj	DEROGATORY
feign_verb	simulieren_verb	OTHER
feint_noun	Simulation_noun	OTHER
felon_noun	Schwerverbrecher_noun	DEROGATORY
felonious_adj	verbrecherisch_adj	DEROGATORY
fetid_adj	übelriechend_adj	DEROGATORY
fiasco_noun	Fiasko_noun	OTHER
fiat_noun	Ermächtigung_noun	OTHER
fib_noun	Flunkerei_noun	OTHER
fibber_noun	Schwindler_noun	DEROGATORY
fickle_adj	wankelmütig_adj	OTHER
fictional_adj	fiktiv_adj	OTHER
fidget_verb	herumzappeln_verb	OTHER
fidgety_adj	zappelig_adj	OTHER
fiend_noun	Furie_noun	DEROGATORY
figurehead_noun	Strohmann_noun	OTHER
filthy_adj	dreckig_adj	DEROGATORY
finagle_verb	mogeln_verb	OTHER
finocchio_noun	?	DEROGATORY
flak_noun	Kritik_noun	OTHER
flaky_adj	verrückt_adj	DEROGATORY
flamer_noun	Tunte_noun	DEROGATORY
flashy_adj	grell_adj	OTHER
flaunt_verb	herumstolzieren_verb	OTHER
flaw_noun	Schönheitsfehler_noun	OTHER
fleeting_adj	flüchtig_adj	OTHER
flid_noun	?	DEROGATORY
flimflam_noun	Mumpitz_noun	OTHER
flirt_verb	flirten_verb	OTHER
flounder_verb	stammeln_verb	OTHER
flout_verb	verspotten_verb	OTHER
fluster_verb	durcheinanderbringen_verb	OTHER
fool_verb	beschwindeln_verb	OTHER
foolishness_noun	Dummheit_noun	DEROGATORY
forbidden_adj	verboten_adj	OTHER
force_verb	zwingen_verb	OTHER
forceful_adj	schlagkräftig_adj	OTHER
formidable_adj	gefürchtet_adj	OTHER
foul_verb	beschmutzen_verb	DEROGATORY
foulness_noun	Verdorbenheit_noun	DEROGATORY
fracture_verb	zerbrechen_verb	OTHER
frantic_adj	rasend_adj	OTHER
fraudulent_adj	lügenhaft_adj	DEROGATORY
frazzled_adj	zerfetzt_adj	OTHER
freak_verb	ausflippen_verb	OTHER
freakish_adj	ausgeflippt_adj	DEROGATORY
frenzy_noun	Ekstase_noun	OTHER
fret_verb	anfressen_verb	OTHER
fretful_adj	gereizt_adj	OTHER
frighten_verb	erschrecken_verb	OTHER
frigid_adj	frigide_adj	DEROGATORY
frocio_noun	?	DEROGATORY
frown_noun	Stirnrunzeln_noun	OTHER
frustrate_verb	frustrieren_verb	OTHER
frustrating_adj	frustrierend_adj	OTHER
frustration_noun	Frustration_noun	OTHER
fuck_noun	Fick_noun	DEROGATORY
fuck_verb	ficken_verb	DEROGATORY
fudge_noun	Schummelei_noun	OTHER
fulminate_verb	wettern_verb	OTHER
fumble_verb	umhertasten_verb	OTHER
fury_noun	Wut_noun	OTHER
fuss_verb	jammern_verb	OTHER
gainsay_verb	abstreiten_verb	OTHER
gall_verb	wundreiben_verb	OTHER
gamble_noun	Glücksspiel_noun	OTHER
gamble_verb	zocken_verb	OTHER
gape_verb	starren_verb	OTHER
gauche_adj	linkisch_adj	DEROGATORY
gaudy_adj	prunkhaft_adj	OTHER
geezer_noun	Knacker?_noun	DEROGATORY
genocide_noun	Völkermord_noun	DEROGATORY
gibber_verb	brabbeln_verb	DEROGATORY
ginger_noun	Rotschopf_noun	DEROGATORY
ginzo_noun	Itaker_noun	DEROGATORY
gippo_noun	Zigeuner_noun	DEROGATORY
glare_verb	anstarren_verb	OTHER
glaring_adj	himmelschreiend_adj	OTHER
gloomy_adj	düster_adj	OTHER
gloss_verb	beschönigen_verb	OTHER
glower_verb	?	OTHER
goad_verb	aufreizen_verb	OTHER
gobber_noun	?	DEROGATORY
goof_noun	Depp_noun	OTHER
goof_verb	vermasseln_verb	DEROGATORY
gook_noun	Schlitzauge_noun	DEROGATORY
gossip_noun	Tratsch_noun	DEROGATORY
gossip_verb	tratschen_verb	DEROGATORY
graceless_adj	schamlos_adj	DEROGATORY
graft_noun	Schufterei_noun	OTHER
grave_adj	schwerwiegend_adj	OTHER
greaseball_noun	Schmalzkopf_noun	DEROGATORY
greed_noun	Habgier_noun	DEROGATORY
grievance_noun	Klage_noun	OTHER
grill_verb	grillen_verb	OTHER
grimace_verb	grimassieren_verb	DEROGATORY
grind_noun	Rackerei_noun	OTHER
gringo_noun	Gringo_noun	DEROGATORY
gripe_verb	meckern_verb	OTHER
groid_noun	Neger_noun	DEROGATORY
grotesque_adj	grotesk_adj	DEROGATORY
grouch_noun	Miesepeter_noun	DEROGATORY
grouchy_adj	griesgrämig_adj	DEROGATORY
grouse_verb	nörgeln_verb	OTHER
growl_verb	knurren_verb	OTHER
grudge_verb	missgönnen_verb	OTHER
gruesome_adj	grausig_adj	DEROGATORY
gubba_noun	Kotze_noun	DEROGATORY
guilt_noun	Schuld_noun	OTHER
guilty_adj	schuldig_adj	OTHER
gurrier_noun	Lümmel_noun	DEROGATORY
gyp_noun	Gauner_noun	DEROGATORY
gyppo_noun	Zigeuner_noun	DEROGATORY
haggle_verb	feilschen_verb	OTHER
hairyback_noun	?	DEROGATORY
halfhearted_adj	halbherzig_adj	DEROGATORY
halfrican_noun	?	DEROGATORY
hallucination_noun	Halluzination_noun	OTHER
hamper_verb	behindern_verb	OTHER
handicapped_adj	behindert_adj	OTHER
haphazard_adj	willkürlich_adj	DEROGATORY
harangue_verb	?	OTHER
hard_adj	schwer_adj	OTHER
harden_verb	verhärten_verb	OTHER
harmful_adj	schädlich_adj	OTHER
harridan_noun	Tussi_noun	DEROGATORY
haste_noun	Eile_noun	OTHER
hate_verb	hassen_verb	DEROGATORY
hateful_adj	hasserfüllt_adj	DEROGATORY
hater_noun	Hasser_noun	DEROGATORY
haunt_verb	heimsuchen_verb	OTHER
haunting_adj	gespenstig_adj	OTHER
hayseed_noun	Landei_noun	DEROGATORY
hazard_verb	wagen_verb	OTHER
hazy_adj	diesig_adj	OTHER
heartless_adj	herzlos_adj	DEROGATORY
heartrending_adj	herzzerreißend_adj	OTHER
heathen_noun	Heide_noun	DEROGATORY
heavy-handed_adj	plump_adj	DEROGATORY
heckle_verb	?	DEROGATORY
heeb_noun	?	DEROGATORY
heedless_adj	unachtsam_adj	OTHER
hegemony_noun	Vormachtstellung_noun	OTHER
heresy_noun	Häresie_noun	OTHER
heretical_adj	ketzerisch_adj	DEROGATORY
hesitant_adj	zögernd_adj	OTHER
hick_noun	Hinterwäldler_noun	DEROGATORY
hillbilly_noun	Landpomeranze_noun	DEROGATORY
hinder_verb	aufhalten_verb	OTHER
hindrance_noun	Hindernis_noun	OTHER
hoax_verb	verarschen_verb	DEROGATORY
hobble_verb	hoppeln_verb	OTHER
hoe_noun	Nutte_noun	DEROGATORY
honky_noun	?	DEROGATORY
hoodwink_verb	hereinlegen_verb	OTHER
hopeless_adj	hoffnungslos_adj	DEROGATORY
hopelessness_noun	Hoffnungslosigkeit_noun	OTHER
horrendous_adj	entsetzlich_adj	DEROGATORY
horrid_adj	scheußlich_adj	DEROGATORY
horror_noun	Schrecken_noun	OTHER
hostage_noun	Geisel_noun	OTHER
hostilities_noun	Anfeindung_noun	OTHER
huckster_noun	Profitmacher_noun	DEROGATORY
humiliate_verb	beschämen_verb	DEROGATORY
humping_noun	Trockensex_noun	DEROGATORY
hurt_verb	verletzen_verb	DEROGATORY
hustler_noun	Stricher_noun	DEROGATORY
hypocrite_noun	Heuchler_noun	DEROGATORY
hysterics_noun	Hysterie_noun	OTHER
idiocy_noun	Schwachsinn_noun	DEROGATORY
idiot_noun	Idiot_noun	DEROGATORY
idle_adj	untätig_adj	OTHER
ignominious_adj	schmachvoll_adj	OTHER
ignominy_noun	Schmach_noun	OTHER
ignorant_adj	ignorant_adj	DEROGATORY
ignore_verb	ignorieren_verb	OTHER
ikey_noun	?	DEROGATORY
ill-conceived_adj	unausgereift_adj	OTHER
illicit_adj	unerlaubt_adj	OTHER
illusion_noun	Illusion_noun	OTHER
imbalance_noun	Ungleichgewicht_noun	OTHER
imbecile_noun	Blödmann_noun	DEROGATORY
imbroglio_noun	Verwicklungen_noun	OTHER
immaterial_adj	bedeutungslos_adj	OTHER
immoral_adj	sittenlos_adj	DEROGATORY
immorality_noun	Sittenlosigkeit_noun	DEROGATORY
impair_verb	beeinträchtigen_verb	OTHER
impasse_noun	Sackgasse_noun	OTHER
impeach_verb	anklagen_verb	OTHER
impede_verb	hemmen_verb	OTHER
imperfect_adj	unvollkommen_adj	OTHER
imperil_verb	gefährden_verb	OTHER
imperious_adj	gebieterisch_adj	DEROGATORY
impermissible_adj	unzulässig_adj	OTHER
impersonal_adj	unpersönlich_adj	OTHER
impertinent_adj	unverfroren_adj	DEROGATORY
impetuous_adj	ungestüm_adj	OTHER
impiety_noun	Gottlosigkeit_noun	DEROGATORY
implacable_adj	unerbittlich_adj	OTHER
implicate_verb	verwickeln_verb	OTHER
impolitic_adj	unklug_adj	OTHER
importunate_adj	hartnäckig_adj	OTHER
importune_verb	behelligen_verb	OTHER
impose_verb	verhängen_verb	OTHER
imposition_noun	Auferlegung_noun	OTHER
impoverish_verb	verarmen_verb	OTHER
impoverished_adj	verarmt_adj	OTHER
impractical_adj	unpraktisch_adj	OTHER
imprecise_adj	ungenau_adj	OTHER
improbable_adj	unwahrscheinlich_adj	OTHER
imprudence_noun	Unklugheit_noun	OTHER
impugn_verb	hinterfragen_verb	OTHER
impulsive_adj	impulsiv_adj	OTHER
impurity_noun	Unreinheit_noun	OTHER
inaccessible_adj	unzugänglich_adj	OTHER
inapt_adj	unpassend_adj	OTHER
incendiary_adj	aufwiegelnd_adj	OTHER
incense_verb	beweihräuchern_verb	OTHER
incitement_noun	Anstiftung_noun	OTHER
incivility_noun	Grobheit_noun	OTHER
inclement_adj	unfreundlich_adj	OTHER
incoherence_noun	Zusammenhangslosigkeit_noun	OTHER
incomparable_adj	unvergleichbar_adj	OTHER
incompetence_noun	Stümperei_noun	DEROGATORY
incomprehensible_adj	unbegreiflich_adj	OTHER
incomprehension_noun	Unverständnis_noun	OTHER
inconceivable_adj	unfassbar_adj	OTHER
inconsiderate_adj	rücksichtslos_adj	DEROGATORY
inconsistency_noun	Inkonsistenz_noun	OTHER
inconsistent_adj	inkonsistent_adj	OTHER
inconsolable_adj	untröstlich_adj	OTHER
inconvenience_noun	Unannehmlichkeit_noun	OTHER
incorrect_adj	inkorrekt_adj	OTHER
incorrigible_adj	unverbesserlich_adj	DEROGATORY
inculcate_verb	indoktrinieren_verb	OTHER
indecency_noun	Unanständigkeit_noun	OTHER
indefensible_adj	unvertretbar_adj	OTHER
indeterminate_adj	unbestimmt_adj	OTHER
indignation_noun	Ungehaltenheit_noun	OTHER
indignity_noun	Demütigung_noun	OTHER
indiscreet_adj	indiskret_adj	OTHER
indiscretion_noun	Indiskretion_noun	OTHER
indiscriminate_adj	wahllos_adj	OTHER
indulge_verb	verhätscheln_verb	OTHER
inefficacy_noun	Unwirksamkeit_noun	OTHER
inefficiency_noun	Ineffizienz_noun	OTHER
ineptitude_noun	Ungeeignetheit_noun	DEROGATORY
inequality_noun	Ungleichheit_noun	OTHER
inequitable_adj	ungerecht_adj	OTHER
inertia_noun	Trägheit_noun	OTHER
inessential_adj	unwesentlich_adj	OTHER
inevitable_adj	unvermeidbar_adj	OTHER
inexact_adj	ungenau_adj	OTHER
inexcusable_adj	unverzeihlich_adj	OTHER
inexperienced_adj	unerfahren_adj	OTHER
inexpert_adj	ungeübt_adj	OTHER
infamous_adj	berüchtigt_adj	OTHER
inferior_adj	nachrangig_adj	OTHER
infernal_adj	höllisch_adj	OTHER
infidel_noun	Ungläubige_noun	DEROGATORY
infiltrator_noun	Infiltrator_noun	DEROGATORY
inflammatory_adj	aufrührerisch_adj	OTHER
infraction_noun	Übertretung_noun	OTHER
infringe_verb	verstoßen_verb	OTHER
infringement_noun	Zuwiderhandlung_noun	OTHER
inglorious_adj	ruhmlos_adj	OTHER
ingrate_noun	?	DEROGATORY
inhibit_verb	unterbinden_verb	OTHER
inhibition_noun	Unterbindung_noun	OTHER
inhospitality_noun	Unwirtlichkeit_noun	DEROGATORY
inhumanity_noun	Unmenschlichkeit_noun	DEROGATORY
inimical_adj	schädlich_adj	OTHER
iniquity_noun	Missetat_noun	OTHER
injun_noun	Rothaut_noun	DEROGATORY
injure_verb	verwunden_verb	OTHER
injury_noun	Verletzung_noun	OTHER
injustice_noun	Ungerechtigkeit_noun	OTHER
innuendo_noun	Anzüglichkeit_noun	OTHER
inordinate_adj	ungeregelt_adj	OTHER
insane_adj	irrsinnig_adj	DEROGATORY
insanity_noun	Irrsinnigkeit_noun	DEROGATORY
insecurity_noun	Unsicherheit_noun	OTHER
insensible_adj	empfindungslos_adj	OTHER
insignificance_noun	Geringfügigkeit_noun	OTHER
insignificant_adj	geringfügig_adj	OTHER
insincerity_noun	Unaufrichtigkeit_noun	DEROGATORY
insinuate_verb	unterstellen_verb	OTHER
instigate_verb	anstiften_verb	OTHER
instigator_noun	Anstifter_noun	OTHER
insubordinate_adj	aufmüpfig_adj	DEROGATORY
insufferable_adj	unausstehlich_adj	DEROGATORY
insufficient_adj	unzureichend_adj	OTHER
insult_noun	Beleidigung_noun	DEROGATORY
insulting_adj	beleidigend_adj	DEROGATORY
insurmountable_adj	unüberwindbar_adj	OTHER
insurrection_noun	Aufstand_noun	OTHER
interference_noun	Einmischung_noun	OTHER
intermittent_adj	unterbrochen_adj	OTHER
intimidate_verb	einschüchtern_verb	DEROGATORY
intimidating_adj	einschüchternd_adj	OTHER
intimidation_noun	Einschüchterung_noun	DEROGATORY
intractable_adj	heikel_adj	OTHER
intransigence_noun	Kompromisslosigkeit_noun	OTHER
intrude_verb	eindrängen_verb	DEROGATORY
intrusive_adj	aufdringlich_adj	OTHER
invader_noun	Eindringling_noun	OTHER
invalid_adj	ungültig_adj	OTHER
invasive_adj	angreifend_adj	OTHER
invective_noun	Beschimpfungen_noun	DEROGATORY
invidious_adj	gehässig_adj	DEROGATORY
irk_verb	ärgern_verb	OTHER
irony_noun	Ironie_noun	OTHER
irreparable_adj	irreparabel_adj	OTHER
irrepressible_adj	unbezähmbar_adj	OTHER
irreverence_noun	Geringschätzung_noun	OTHER
irreverent_adj	pietätlos_adj	OTHER
irreversible_adj	unumkehrbar_adj	OTHER
irritant_noun	Nerversäge_noun	DEROGATORY
irritate_verb	reizen_verb	OTHER
isolate_verb	isolieren_verb	OTHER
isolated_adj	vereinsamt_adj	OTHER
ivory_noun	?	DEROGATORY
jagoff_noun	Wichser_noun	DEROGATORY
jealous_adj	eifersüchtig_adj	DEROGATORY
jeer_verb	höhnen_verb	DEROGATORY
jeopardize_verb	gefährden_verb	OTHER
jerk_noun	Knilch_noun	DEROGATORY
jigaboo_noun	Neger_noun	DEROGATORY
jittery_adj	rappelig_adj	OTHER
joker_noun	Scherzkeks_noun	OTHER
jumpy_adj	schreckhaft_adj	OTHER
juvenile_adj	kindisch_adj	OTHER
kaput_adj	kaputt_adj	OTHER
keen_verb	wehklagen_verb	OTHER
kick_noun	Tritt_noun	DEROGATORY
kike_noun	Itzig_noun	DEROGATORY
kill_verb	töten_verb	DEROGATORY
killer_noun	Killer_noun	DEROGATORY
knock_noun	Schlag_noun	OTHER
knock_verb	schlagen_verb	OTHER
kook_noun	Spinner_noun	DEROGATORY
kooky_adj	verrückt_adj	DEROGATORY
kraut_noun	Krautfresser_noun	DEROGATORY
kyke_noun	Itzig_noun	DEROGATORY
lackadaisical_adj	lasch_adj	DEROGATORY
laconic_adj	lakonisch_adj	OTHER
lambast_verb	verbrügeln_verb	OTHER
languor_noun	Mattigkeit_noun	OTHER
lapse_noun	Versehen_noun	OTHER
last-ditch_adj	letzter_adj	OTHER
latrino_noun	?	DEROGATORY
laughter_noun	Gelächter_noun	OTHER
lawless_adj	gesetzlos_adj	OTHER
lax_adj	lax_adj	OTHER
lech_noun	?	OTHER
lecher_noun	Lustmolch_noun	DEROGATORY
lechery_noun	Geilheit_noun	DEROGATORY
lecture_verb	belehren_verb	OTHER
leer_verb	?	DEROGATORY
lesbo_noun	Lesbe_noun	DEROGATORY
lethal_adj	tödlich_adj	OTHER
lethargy_noun	Lethargie_noun	OTHER
lewd_adj	lüstern_adj	DEROGATORY
lewdness_noun	Lüsternheit_noun	DEROGATORY
lezzie_noun	Lesbe_noun	DEROGATORY
liable_adj	haftbar_adj	OTHER
licentious_adj	zügellos_adj	DEROGATORY
lie_verb	lügen_verb	DEROGATORY
lifeless_adj	leblos_adj	OTHER
loath_adj	abgeneigt_adj	OTHER
loathing_noun	Abscheu_noun	OTHER
loathsome_adj	widerlich_adj	DEROGATORY
lonely_adj	einsam_adj	OTHER
loophole_noun	Schlupfloch_noun	OTHER
loot_verb	plündern_verb	OTHER
loser_noun	Versager_noun	DEROGATORY
lousy_adj	lausig_adj	DEROGATORY
loveless_adj	lieblos_adj	OTHER
lubra_noun	?	DEROGATORY
lugubrious_adj	wehmütig_adj	OTHER
lukewarm_adj	lauwarm_adj	OTHER
lull_verb	einlullen_verb	OTHER
lurch_verb	schlingern_verb	OTHER
lurid_adj	reißerisch_adj	DEROGATORY
lurk_verb	lauern_verb	DEROGATORY
madman_noun	Wahnsinniger_noun	DEROGATORY
madness_noun	Wahnsinn_noun	DEROGATORY
maggot_noun	Made_noun	DEROGATORY
malady_noun	Krankheit_noun	OTHER
malaise_noun	Unpässlichkeit_noun	OTHER
maliciousness_noun	Böswilligkeit_noun	DEROGATORY
malign_adj	unheilvoll_adj	OTHER
malign_verb	schlechtmachen_verb	DEROGATORY
malodorous_adj	stinkig_adj	DEROGATORY
maneuver_noun	Manöver_noun	OTHER
mangle_verb	wringen_verb	OTHER
manipulative_adj	manipulativ_adj	DEROGATORY
mar_verb	trüben_verb	OTHER
marginal_adj	marginal_adj	OTHER
massacre_verb	abschlachten_verb	DEROGATORY
mawkish_adj	rührselig_adj	OTHER
melodramatic_adj	melodramatisch_adj	OTHER
menace_noun	Drohung_noun	OTHER
merciless_adj	unbarmherzig_adj	DEROGATORY
mere_adj	bloß_adj	OTHER
messy_adj	unordentlich_adj	OTHER
midget_noun	Wicht_noun	DEROGATORY
militancy_noun	Kampfgeist_noun	OTHER
mind_verb	bedenken_verb	OTHER
misbegotten_adj	unehelich_adj	OTHER
misbehave_verb	danebenbenehmen_verb	OTHER
miscalculate_verb	verrechnen_verb	OTHER
miscalculation_noun	Rechenfehler_noun	OTHER
mischief_noun	Unheil_noun	OTHER
miser_noun	Geizkragen_noun	DEROGATORY
miserly_adj	geizig_adj	OTHER
misery_noun	Misere_noun	OTHER
misfortune_noun	Unglück_noun	OTHER
misinform_verb	fehlinformieren_verb	OTHER
misinterpret_verb	fehlinterpretieren_verb	OTHER
misjudge_verb	verkennen_verb	OTHER
mislead_verb	irreführen_verb	OTHER
misleading_adj	irreführend_adj	OTHER
mismanage_verb	mismanage_verb	OTHER
misread_verb	missdeuten_verb	OTHER
misreading_noun	Missdeutung_noun	OTHER
misrepresent_verb	verdrehen_verb	OTHER
misstatement_noun	Fehldarstellung_noun	OTHER
mistrust_noun	Misstrauen_noun	OTHER
mistrustful_adj	misstrauisch_adj	OTHER
misuse_verb	missbrauchen_verb	OTHER
moan_verb	stöhnen_verb	OTHER
mock_verb	verhöhnen_verb	OTHER
mockery_noun	Nachäfferei_noun	DEROGATORY
molest_verb	anpöblen_verb	DEROGATORY
molestation_noun	Belästigung_noun	DEROGATORY
mong_noun	?	DEROGATORY
monotonous_adj	monoton_adj	OTHER
monster_noun	Monster_noun	DEROGATORY
mook_noun	Schnösel_noun	DEROGATORY
moon_verb	?	OTHER
mope_verb	?	DEROGATORY
moribund_adj	erstarrend_adj	OTHER
moron_noun	Trottel_noun	DEROGATORY
mortification_noun	Kränkung_noun	OTHER
motherfucker_noun	Mutterficker_noun	DEROGATORY
motionless_adj	bewegungslos_adj	OTHER
mourner_noun	Trauernde_noun	OTHER
muddle_verb	durcheinanderbringen_verb	OTHER
muddy_adj	schlammig_adj	OTHER
mudslinging_noun	Schlammschlacht_noun	DEROGATORY
muff_noun	Tölpel_noun	DEROGATORY
mulato_noun	Mulatte_noun	DEROGATORY
murder_noun	Mord_noun	DEROGATORY
murder_verb	ermorden_verb	DEROGATORY
mutt_noun	Köter_noun	DEROGATORY
muzzie_noun	?	DEROGATORY
mysterious_adj	rätselhaft_adj	OTHER
mystery_noun	Rätsel_noun	OTHER
mystify_verb	verblüffen_verb	OTHER
myth_noun	Mythos_noun	OTHER
nacho_noun	?	DEROGATORY
nag_verb	keifen_verb	DEROGATORY
nagging_adj	keifend_adj	DEROGATORY
nastiness_noun	Garstigkeit_noun	DEROGATORY
nasty_adj	garstig_adj	DEROGATORY
nauseate_verb	?	OTHER
nebulous_adj	nebulös_adj	OTHER
need_noun	Not_noun	OTHER
need_verb	brauchen_verb	OTHER
needy_adj	bedürftig_adj	OTHER
nefarious_adj	schändlich_adj	DEROGATORY
negation_noun	Negation_noun	OTHER
neglect_verb	vernachlässigen_verb	OTHER
negligence_noun	Schlampigkeit_noun	DEROGATORY
negligent_adj	schlampig_adj	DEROGATORY
negro_noun	Bimbo_noun	DEROGATORY
nervous_adj	nervös_adj	OTHER
nervousness_noun	Nervosität_noun	OTHER
nettle_verb	reizen_verb	OTHER
nigger_noun	Nigger_noun	DEROGATORY
niggle_verb	nörgeln_verb	OTHER
nightmare_noun	Albtraum_noun	OTHER
niglet_noun	Negerlein_noun	DEROGATORY
noisy_adj	laut_adj	OTHER
nonsense_noun	Unsinn_noun	DEROGATORY
notorious_adj	notorisch_adj	OTHER
nuisance_noun	Quälgeist_noun	DEROGATORY
numb_verb	betäuben_verb	OTHER
nutsack_noun	Sack_noun	DEROGATORY
object_verb	widersprechen_verb	OTHER
objection_noun	Widerspruch_noun	OTHER
oblique_adj	schief_adj	OTHER
obliterate_verb	ausmerzen_verb	DEROGATORY
obscene_adj	obszön_adj	DEROGATORY
obscenity_noun	Obszönität_noun	DEROGATORY
obsess_verb	reinsteigern_verb	DEROGATORY
obsession_noun	Obsession_noun	OTHER
obsessiveness_noun	Zwanghaftigkeit_noun	DEROGATORY
obsolete_adj	veraltet_adj	OTHER
obstacle_noun	Hindernis_noun	OTHER
obstruct_verb	versperren_verb	OTHER
ocker_noun	?	DEROGATORY
oddity_noun	Kuriosität_noun	OTHER
ofay_noun	?	DEROGATORY
offence_noun	Vergehen_noun	OTHER
officious_adj	wichtigmacherisch_adj	DEROGATORY
omission_noun	Wegfall_noun	OTHER
omit_verb	weglassen_verb	OTHER
one-sided_adj	einseitig_adj	OTHER
onslaught_noun	Ansturm_noun	DEROGATORY
opinionated_adj	eigensinnig_adj	OTHER
oppress_verb	unterdrücken_verb	OTHER
ostracize_verb	verbannen_verb	OTHER
outburst_noun	Zornausbruch_noun	OTHER
outcry_noun	Aufschrei_noun	OTHER
outlaw_noun	Geächtete_noun	OTHER
outmoded_adj	überholt_adj	OTHER
outrage_verb	entrüsten_verb	OTHER
outrageousness_noun	Frevelhaftigkeit_noun	DEROGATORY
overact_verb	überspielen_verb	OTHER
overdo_verb	überziehen_verb	OTHER
overemphasize_verb	überbewerten_verb	OTHER
overplay_verb	übertreiben_verb	OTHER
overpower_verb	überwältigen_verb	OTHER
overrun_verb	überfahren_verb	OTHER
overshadow_verb	überschatten_verb	OTHER
oversimplification_noun	Vergröberung_noun	OTHER
oversized_adj	überdimensioniert_adj	OTHER
overstatement_noun	Übertreibung_noun	OTHER
overthrow_verb	umstürzen_verb	OTHER
overturn_verb	umstoßen_verb	OTHER
overwhelm_verb	überfordern_verb	OTHER
overzealous_adj	übereifrig_adj	DEROGATORY
paki_noun	Paki_noun	DEROGATORY
paleface_noun	Bleichgesicht_noun	DEROGATORY
pan_verb	verreißen_verb	OTHER
pandemonium_noun	Tumult_noun	OTHER
panic_noun	Panik_noun	OTHER
panic_verb	durchdrehen_verb	OTHER
pansy_noun	Weichei_noun	DEROGATORY
paradoxical_adj	paradox_adj	OTHER
paranoia_noun	Paranoia_noun	DEROGATORY
paranoid_adj	paranoid_adj	DEROGATORY
parody_verb	parodieren_verb	OTHER
partisan_noun	Partisan_noun	OTHER
passe_adj	passe_adj	OTHER
passiveness_noun	Passivität_noun	OTHER
payback_noun	Vergeltung_noun	OTHER
peculiar_adj	sonderbar_adj	OTHER
peeved_adj	pikiert_adj	OTHER
peevish_adj	verdrießlich_adj	DEROGATORY
penalize_verb	bestrafen_verb	OTHER
penalty_noun	Bestrafung_noun	OTHER
penis_noun	Penis_noun	DEROGATORY
perfidious_adj	treulos_adj	OTHER
perfunctory_adj	nachlässig_adj	DEROGATORY
peril_noun	Tücke_noun	OTHER
peripheral_adj	peripher_adj	OTHER
perish_verb	verenden_verb	DEROGATORY
perplexity_noun	Ratlosigkeit_noun	OTHER
perturbed_adj	verstört_adj	OTHER
perverse_adj	pervers_adj	DEROGATORY
perversion_noun	Perversion_noun	DEROGATORY
pervert_verb	pervertieren_verb	OTHER
perverted_adj	pervertiert_adj	DEROGATORY
pessimism_noun	Pessimismus_noun	OTHER
petrify_verb	versteinern_verb	OTHER
phobia_noun	Phobie_noun	OTHER
phobic_adj	phobisch_adj	OTHER
pillage_verb	brandschatzen_verb	OTHER
pillory_verb	anprangern_verb	OTHER
pinch_noun	Kniff_noun	OTHER
pique_verb	pikieren_verb	OTHER
piss_verb	pissen_verb	DEROGATORY
pittance_noun	Hungerlohn_noun	OTHER
pity_noun	Mitleid_noun	OTHER
plagiarize_verb	plagiieren_verb	OTHER
plague_noun	Pest_noun	DEROGATORY
plebeian_adj	plebejisch_adj	OTHER
plight_noun	Zwangslage_noun	OTHER
plot_verb	konspirieren_verb	OTHER
plunder_verb	ausplündern_verb	OTHER
pogue_noun	Etappenhengst_noun	DEROGATORY
poisonous_adj	giftig_adj	DEROGATORY
polack_noun	Polacke_noun	DEROGATORY
pollute_verb	verschmutzen_verb	OTHER
pommy_noun	?	DEROGATORY
pompous_adj	wichtigtuerisch_adj	DEROGATORY
pout_verb	schmollen_verb	DEROGATORY
powerless_adj	machtlos_adj	OTHER
prate_verb	plaudern_verb	OTHER
pratfall_noun	Reinfall_noun	OTHER
prattle_verb	schwafeln_verb	DEROGATORY
prejudge_verb	vorverurteilen_verb	OTHER
prejudicial_adj	?	DEROGATORY
preoccupy_verb	absorbieren_verb	OTHER
presume_verb	mutmaßen_verb	OTHER
presumptuous_adj	anmaßend_adj	DEROGATORY
pretence_noun	Anschein_noun	OTHER
pretentious_adj	pompös_adj	DEROGATORY
prevaricate_verb	?	OTHER
pricey_adj	kostspielig_adj	OTHER
prick_noun	Scheißkerl_noun	DEROGATORY
primitive_noun	Primitiver_noun	OTHER
prisoner_noun	Häftling_noun	OTHER
problem_noun	Problem_noun	OTHER
problematic_adj	problematisch_adj	OTHER
procrastinate_verb	zaudern_verb	OTHER
profane_adj	gottlos_adj	DEROGATORY
prohibitive_adj	unerschwinglich_adj	OTHER
propaganda_noun	Propaganda_noun	OTHER
propagandize_verb	propagieren_verb	OTHER
protest_noun	Protest_noun	OTHER
provocation_noun	Provokation_noun	OTHER
provoke_verb	provozieren_verb	OTHER
pry_verb	herumschnüffeln_verb	DEROGATORY
pullock_noun	?	DEROGATORY
punish_verb	strafen_verb	OTHER
punishable_adj	strafbar_adj	OTHER
pussy_noun	Muschi_noun	DEROGATORY
puzzle_verb	rätzeln_verb	OTHER
puzzlement_noun	Verwirrung_noun	OTHER
puzzling_adj	verwirrend_adj	OTHER
quandary_noun	Dilemma_noun	OTHER
quarrel_verb	hadern_verb	OTHER
quash_verb	vernichten_verb	OTHER
queer_adj	?	DEROGATORY
questionable_adj	fraglich_adj	OTHER
quibble_verb	kritteln_verb	OTHER
quit_verb	verlassen_verb	OTHER
racism_noun	Rassismus_noun	OTHER
rack_verb	plagen_verb	OTHER
radical_adj	radikal_adj	OTHER
radicalization_noun	Radikalisierung_noun	OTHER
rage_verb	wüten_verb	OTHER
ragged_adj	rau_adj	OTHER
raghead_noun	Windelkopf_noun	DEROGATORY
raging_adj	rasend_adj	OTHER
rail_verb	schimpfen_verb	OTHER
rampage_verb	randalieren_verb	OTHER
rampant_adj	wild_adj	OTHER
rancor_noun	Verbitterung_noun	OTHER
rant_noun	Schimpftirade_noun	OTHER
rant_verb	schwadronieren_verb	DEROGATORY
rationalize_verb	rationalize_verb	OTHER
ravage_verb	verheeren_verb	OTHER
rebuff_verb	zurückweisen_verb	OTHER
rebuke_verb	zurechtweisen_verb	OTHER
recalcitrant_adj	aufmüpfig_adj	DEROGATORY
recant_verb	widerrufen_verb	OTHER
recession_noun	Flaute_noun	OTHER
recklessness_noun	Draufgängertum_noun	DEROGATORY
recoil_verb	abprallen_verb	OTHER
redneck_noun	Bauerntrampel_noun	DEROGATORY
refuse_verb	weigern_verb	OTHER
regret_verb	bedauern_verb	OTHER
relapse_verb	zurückfallen_verb	OTHER
relentless_adj	unerbittlich_adj	OTHER
remorse_noun	Reue_noun	OTHER
remorseful_adj	reumütig_adj	OTHER
remorseless_adj	erbarmungslos_adj	DEROGATORY
renounce_verb	verleugnen_verb	OTHER
renunciation_noun	Entsagung_noun	OTHER
repel_verb	abwehren_verb	OTHER
reprehensible_adj	tadelnswert_adj	DEROGATORY
repression_noun	Repression_noun	OTHER
reprimand_verb	ermahnen_verb	OTHER
reproach_verb	vorhalten_verb	OTHER
reproachful_adj	vorwurfsvoll_adj	OTHER
reprove_verb	rügen_verb	OTHER
repudiate_verb	dementieren_verb	OTHER
repudiation_noun	Ablehnung_noun	OTHER
repugnance_noun	Widerwille_noun	OTHER
repulse_verb	abweisen_verb	OTHER
resentful_adj	nachtragend_adj	OTHER
resentment_noun	Unmut_noun	OTHER
restrict_verb	einschränken_verb	OTHER
restricted_adj	eingeschränkt_adj	OTHER
restriction_noun	Begrenzung_noun	OTHER
restrictive_adj	restriktiv_adj	OTHER
retaliate_verb	vergelten_verb	OTHER
retard_noun	Spasti_noun	DEROGATORY
retire_verb	zurückziehen_verb	OTHER
retract_verb	zurücknehmen_verb	OTHER
revenge_noun	Rache_noun	OTHER
revenge_verb	rächen_verb	OTHER
revengeful_adj	rachsüchtig_adj	DEROGATORY
revile_verb	geifern_verb	DEROGATORY
revoke_verb	aufkündigen_verb	OTHER
revolt_verb	rebellieren_verb	OTHER
revulsion_noun	Abscheu_noun	OTHER
rhetoric_noun	Rhetorik_noun	OTHER
ridicule_noun	Gespött_noun	DEROGATORY
rigorous_adj	drastisch_adj	OTHER
rile_verb	reizen_verb	OTHER
rival_verb	rivalisieren_verb	OTHER
rot_noun	Fäule_noun	DEROGATORY
rotten_adj	hundsgemein_adj	DEROGATORY
rough_adj	spröde_adj	OTHER
roundeye_noun	?	DEROGATORY
rude_adj	unverschämt_adj	DEROGATORY
ruffian_noun	Grobian_noun	DEROGATORY
ruffle_verb	durcheinanderbringen_verb	OTHER
ruthlessness_noun	Unbarmherzigkeit_noun	DEROGATORY
sad_adj	traurig_adj	OTHER
sadden_verb	betrüben_verb	OTHER
sadness_noun	Traurigkeit_noun	OTHER
sag_verb	abschlaffen_verb	OTHER
sanctimonious_adj	scheinheilig_adj	DEROGATORY
sarcasm_noun	Sarkasmus_noun	OTHER
sass_noun	?	OTHER
satirize_verb	persiflieren_verb	OTHER
savage_adj	unzivilisiert_adj	DEROGATORY
savage_verb	anfallen_verb	DEROGATORY
scag_noun	?	DEROGATORY
scandalize_verb	anecken_verb	DEROGATORY
scank_noun	Schlampe_noun	DEROGATORY
scar_noun	Narbe_noun	OTHER
scar_verb	vernarben_verb	OTHER
scarcity_noun	Verknappung_noun	OTHER
scare_verb	vergraulen_verb	OTHER
scared_adj	verängstigt_adj	OTHER
scathing_adj	beißend_adj	OTHER
scheming_adj	intrigant_adj	DEROGATORY
schlong_noun	Pimmel_noun	DEROGATORY
schmuck_noun	Beknackte_noun	DEROGATORY
scold_verb	ausschimpfen_verb	OTHER
scorn_verb	verhöhnen_verb	OTHER
scoundrel_noun	Halunke_noun	DEROGATORY
scowl_verb	?	DEROGATORY
screech_noun	Kreischen_noun	OTHER
scum_noun	Abschaum_noun	DEROGATORY
second-class_adj	zweitklassig_adj	DEROGATORY
sedentary_adj	sesshaft_adj	OTHER
seedy_adj	zwielichtig_adj	DEROGATORY
seethe_verb	brodeln_verb	OTHER
self-defeating_adj	zwecklos_adj	OTHER
self-destructive_adj	selbstzerstörerisch_adj	OTHER
self-interested_adj	eigennützig_adj	DEROGATORY
seriousness_noun	Ernsthaftigkeit_noun	OTHER
sermonize_verb	predigen_verb	OTHER
servitude_noun	Knechtschaft_noun	DEROGATORY
shabby_adj	marode_adj	OTHER
shady_adj	anrüchig_adj	DEROGATORY
shaky_adj	klapprig_adj	OTHER
shallow_adj	seicht_adj	OTHER
sham_adj	zwielichtig_adj	DEROGATORY
shame_noun	Schande_noun	DEROGATORY
shame_verb	beschämen_verb	DEROGATORY
shamelessness_noun	Schamlosigkeit_noun	DEROGATORY
shatter_verb	zerschellen_verb	OTHER
shirk_verb	kneifen_verb	DEROGATORY
shirker_noun	Drückeberger_noun	DEROGATORY
shit_noun	Kacke_noun	DEROGATORY
shitty_adj	beschissen_adj	DEROGATORY
shock_verb	schockieren_verb	OTHER
shortchange_verb	ausnutzen_verb	OTHER
shrew_noun	Widerspenstige_noun	OTHER
shriek_verb	schreien_verb	OTHER
shrill_adj	schrill_adj	OTHER
shrivel_verb	verwelken_verb	OTHER
shroud_verb	verstecken_verb	OTHER
shrug_verb	abtun_verb	OTHER
shyster_noun	Ganove_noun	DEROGATORY
sickness_noun	Erkrankung_noun	OTHER
sidetrack_verb	ablenken_verb	OTHER
siege_noun	Belagerung_noun	OTHER
silly_adj	blöd_adj	DEROGATORY
skanger_noun	Prolet_noun	DEROGATORY
skeptical_adj	skeptisch_adj	OTHER
skepticism_noun	Skepsis_noun	OTHER
sketchy_adj	?	DEROGATORY
skimpy_adj	knapp_adj	OTHER
skittish_adj	schreckhaft_adj	OTHER
slander_noun	Verleumdung_noun	DEROGATORY
slander_verb	verleumden_verb	OTHER
slanderous_adj	ehrenrührig_adj	DEROGATORY
slant_noun	?	DEROGATORY
slap_verb	ohrfeigen_verb	DEROGATORY
slaughter_verb	abschlachten_verb	DEROGATORY
sleazy_adj	schmierig_adj	DEROGATORY
slight_noun	Kränkung_noun	OTHER
slight_verb	vernachlässigen_verb	OTHER
slothful_adj	faul_adj	DEROGATORY
slow-moving_adj	zähfließend_adj	OTHER
slow_adj	langsam_adj	OTHER
sluggish_adj	lahm_adj	DEROGATORY
slump_noun	Abschwung_noun	OTHER
slut_noun	Luder_noun	DEROGATORY
sly_adj	verschlagen_adj	OTHER
smash_verb	zertrümmern_verb	OTHER
smokescreen_noun	Vorwand_noun	OTHER
smother_verb	ersticken_verb	OTHER
smoulder_verb	qualmen_verb	OTHER
smug_adj	selbstzufrieden_adj	DEROGATORY
smut_noun	Schweinkram_noun	DEROGATORY
snarl_noun	Knurren_noun	OTHER
snarl_verb	knurren_verb	OTHER
sneak_verb	schleichen_verb	OTHER
sneaky_adj	feige_adj	DEROGATORY
sneer_noun	Hohngelächter_noun	DEROGATORY
sneer_verb	höhnen_verb	DEROGATORY
snout_noun	Schnauze_noun	DEROGATORY
snowflake_noun	Mimose_noun	DEROGATORY
sob_verb	schluchzen_verb	OTHER
sober_adj	nüchtern_adj	OTHER
sorrow_noun	Kummer_noun	OTHER
sorrowful_adj	kummervoll_adj	OTHER
sorry_adj	bekümmert_adj	OTHER
sour_adj	sauertöpfisch_adj	DEROGATORY
spank_verb	verhauen_verb	OTHER
spick_noun	?	DEROGATORY
spide_noun	?	DEROGATORY
spigger_noun	?	DEROGATORY
spite_noun	Groll_noun	OTHER
spiteful_adj	gehässig_adj	DEROGATORY
spitefulness_noun	Gehässigkeit_noun	DEROGATORY
split_verb	spalten_verb	OTHER
spoil_verb	verderben_verb	DEROGATORY
spook_verb	herumgeistern_verb	OTHER
spurn_verb	?	DEROGATORY
sputter_verb	stottern_verb	OTHER
squander_verb	vergeuden_verb	OTHER
squash_verb	quetschen_verb	OTHER
squaw_noun	Squaw_noun	DEROGATORY
stagger_verb	wanken_verb	OTHER
stagnation_noun	Stagnation_noun	OTHER
stale_adj	abgestanden_adj	OTHER
startling_adj	bestürzend_adj	OTHER
starvation_noun	Hungertod_noun	OTHER
starve_verb	verhungern_verb	OTHER
stealing_noun	Stehlen_noun	OTHER
steep_adj	steil_adj	OTHER
stench_noun	Gestank_noun	DEROGATORY
stern_adj	strikt_adj	OTHER
stigmatize_verb	brandmarken_verb	OTHER
stink_noun	Mief_noun	DEROGATORY
stink_verb	stinken_verb	DEROGATORY
stinking_adj	stinkend_adj	DEROGATORY
stodgy_adj	öde_adj	OTHER
storm_verb	stürmen_verb	OTHER
strange_adj	wunderlich_adj	DEROGATORY
stranger_noun	Fremde_noun	OTHER
strangle_verb	strangulieren_verb	DEROGATORY
stress_noun	Anstrengung_noun	OTHER
strident_adj	kreischend_adj	OTHER
struggle_noun	Bemühung_noun	OTHER
stubborn_adj	dickköpfig_adj	DEROGATORY
stumble_noun	Stolpern_noun	OTHER
stumble_verb	stolpern_verb	OTHER
stump_verb	durcheinanderbringen_verb	OTHER
stun_verb	verblüffen_verb	OTHER
stunt_noun	Trick_noun	OTHER
subordinate_noun	Untergebene_noun	OTHER
subservience_noun	Unterwürfigkeit_noun	OTHER
substandard_adj	minderwertig_adj	DEROGATORY
subtract_verb	schmälern_verb	OTHER
subversion_noun	Staatsgefährdung_noun	OTHER
subvert_verb	untergraben_verb	OTHER
succumb_verb	unterliegen_verb	OTHER
sucker_noun	Schmarotzer_noun	DEROGATORY
suffering_noun	Leiden_noun	OTHER
suffocate_verb	ersticken_verb	OTHER
sugar-coated_adj	geschönt_adj	OTHER
sulk_verb	schmollen_verb	DEROGATORY
sully_verb	beflecken_verb	OTHER
superficial_adj	oberflächlich_adj	OTHER
superficiality_noun	Oberflächlichkeit_noun	OTHER
suppression_noun	Unterdrückung_noun	OTHER
supremacy_noun	Vorherrschaft_noun	OTHER
surrender_noun	Ergebung_noun	OTHER
swagger_verb	prahlen_verb	DEROGATORY
swear_verb	schwören_verb	OTHER
swindle_verb	schwindeln_verb	DEROGATORY
symptom_noun	Krankheitserscheinung_noun	OTHER
taboo_adj	unantastbar_adj	OTHER
taint_verb	beflecken_verb	OTHER
tainted_adj	unrein_adj	OTHER
tangled_adj	verworren_adj	OTHER
tantrum_noun	Ausraster_noun	DEROGATORY
tart_noun	Flittchen_noun	DEROGATORY
taunt_verb	spotten_verb	DEROGATORY
tease_verb	necken_verb	OTHER
tedious_adj	nervtödend_adj	DEROGATORY
temper_noun	Laune_noun	OTHER
tempest_noun	Gewitter_noun	OTHER
tense_adj	angespannt_adj	OTHER
tentative_adj	tastend_adj	OTHER
tepid_adj	lau_adj	OTHER
terror_noun	Terror_noun	OTHER
terrorism_noun	Terrorismus_noun	OTHER
terrorize_verb	terroisieren_verb	OTHER
thankless_adj	undankbar_adj	OTHER
thirst_noun	Durst_noun	OTHER
thoughtless_adj	unbekümmert_adj	DEROGATORY
thrash_verb	verhauen_verb	OTHER
threat_noun	Drohung_noun	OTHER
threaten_verb	drohen_verb	OTHER
throttle_verb	erdrosseln_verb	DEROGATORY
throw_verb	schmeißen_verb	OTHER
timidity_noun	Furchtsamkeit_noun	OTHER
tiring_adj	ermüdend_adj	OTHER
toil_verb	mühen_verb	OTHER
toll_noun	Verlustziffer_noun	OTHER
topple_verb	kippen_verb	OTHER
torment_noun	Peinigung_noun	DEROGATORY
torment_verb	schikanieren_verb	DEROGATORY
tortuous_adj	gewunden_adj	OTHER
torture_noun	Folter_noun	DEROGATORY
torture_verb	foltern_verb	DEROGATORY
tortured_adj	gequält_adj	OTHER
toughness_noun	Belastbarkeit_noun	OTHER
traduce_verb	verleumden_verb	OTHER
tragedy_noun	Tragödie_noun	OTHER
traitor_noun	Verräter_noun	DEROGATORY
tramp_noun	Penner_noun	DEROGATORY
trample_verb	trampeln_verb	OTHER
tranny_noun	Transe_noun	DEROGATORY
transgress_verb	überschreiten_verb	OTHER
travesty_noun	Travestie_noun	DEROGATORY
treasonous_adj	verräterisch_adj	DEROGATORY
trick_noun	Streich_noun	OTHER
tricky_adj	knifflig_adj	OTHER
trivial_adj	trivial_adj	OTHER
trivialize_verb	verharmlosen_verb	OTHER
trouble_verb	beunruhigen_verb	OTHER
troublesome_adj	beschwerlich_adj	OTHER
tumultuous_adj	ungestüm_adj	OTHER
twat_noun	Saftarsch_noun	DEROGATORY
twink_noun	?	DEROGATORY
twist_noun	Verwindung_noun	OTHER
twisted_adj	verdorben_adj	DEROGATORY
tyrannical_adj	tyrannisch_adj	DEROGATORY
ugliness_noun	Hässlichkeit_noun	DEROGATORY
ugly_adj	hässlich_adj	DEROGATORY
ultimatum_noun	Ultimatum_noun	OTHER
unable_adj	außerstande_adj	OTHER
unavailable_adj	fehlend_adj	OTHER
unbearable_adj	unerträglich_adj	DEROGATORY
unclear_adj	unklar_adj	OTHER
uncomfortable_adj	unbequem_adj	OTHER
uncontrolled_adj	unkontrolliert_adj	OTHER
underdog_noun	Unterlegene_noun	OTHER
underestimate_verb	unterschätzen_verb	OTHER
undetermined_adj	unentschieden_adj	OTHER
unease_noun	Unbehagen_noun	OTHER
uneasiness_noun	Unbehaglichkeit_noun	OTHER
uneasy_adj	unheimlich_adj	DEROGATORY
uneconomical_adj	unrentabel_adj	OTHER
unethical_adj	skrupellos_adj	DEROGATORY
uneven_adj	ungleich_adj	OTHER
unfaithful_adj	abspenstig_adj	DEROGATORY
unfavorable_adj	unvorteilhaft_adj	OTHER
unfeeling_adj	gefühlskalt_adj	DEROGATORY
unfounded_adj	unbegründet_adj	OTHER
unfriendly_adj	unfreundlich_adj	OTHER
ungovernable_adj	unregierbar_adj	OTHER
unhealthy_adj	krankhaft_adj	DEROGATORY
unilateralism_noun	Unilateralismus_noun	OTHER
unjustified_adj	ungerechtfertigt_adj	OTHER
unlawful_adj	ungesetzlich_adj	OTHER
unlawfulness_noun	Unrechtmäßigkeit_noun	OTHER
unleash_verb	entfesseln_verb	OTHER
unlicensed_adj	unkonzessioniert_adj	OTHER
unlikely_adj	unwahrscheinlich_adj	OTHER
unlucky_adj	unglücklich_adj	OTHER
unnecessary_adj	unnötig_adj	OTHER
unnerving_adj	nervenzermürbend_adj	OTHER
unpleasant_adj	unerfreulich_adj	OTHER
unpopular_adj	unbeliebt_adj	OTHER
unprecedented_adj	beispiellos_adj	OTHER
unreasonable_adj	unangemessen_adj	OTHER
unreliability_noun	Unzuverlässigkeit_noun	OTHER
unruly_adj	renitent_adj	DEROGATORY
unsafe_adj	unsicher_adj	OTHER
unsettle_verb	erschüttern_verb	OTHER
unsophisticated_adj	schlicht_adj	OTHER
unstable_adj	instabil_adj	OTHER
unsteadiness_noun	Unbeständigkeit_noun	OTHER
unsteady_adj	unbeständig_adj	OTHER
unsupported_adj	unbestätigt_adj	OTHER
untenable_adj	unhaltbar_adj	OTHER
untimely_adj	vorzeitig_adj	OTHER
untrue_adj	unwahr_adj	OTHER
unwanted_adj	unerwünscht_adj	DEROGATORY
unwarranted_adj	unvertretbar_adj	OTHER
unwieldy_adj	unhandlich_adj	OTHER
unwillingness_noun	Widerwille_noun	OTHER
unwise_adj	unklug_adj	OTHER
unworthy_adj	unwürdig_adj	DEROGATORY
unyielding_adj	unnachgiebig_adj	OTHER
upbraid_verb	rügen_verb	OTHER
upheaval_noun	Aufruhr_noun	OTHER
uprising_noun	Erhebung_noun	OTHER
uproarious_adj	tobend_adj	OTHER
uproot_verb	entwurzeln_verb	OTHER
upset_verb	verärgern_verb	OTHER
urgency_noun	Dringlichkeit_noun	OTHER
usurp_verb	usurpieren_verb	OTHER
usurper_noun	Thronräuber_noun	DEROGATORY
vanish_verb	verschwinden_verb	OTHER
vehement_adj	vehement_adj	OTHER
vengeful_adj	rachsüchtig_adj	DEROGATORY
vengefulness_noun	Rachsucht_noun	OTHER
vex_verb	bekümmern_verb	OTHER
viciousness_noun	Boshaftigkeit_noun	DEROGATORY
victimize_verb	opfern_verb	OTHER
vile_adj	widerwärtig_adj	DEROGATORY
vilify_verb	schmähen_verb	OTHER
violate_verb	verstoßen_verb	OTHER
violation_noun	Missbrauch_noun	DEROGATORY
violator_noun	Eindringling_noun	OTHER
violent_adj	gewalttätig_adj	DEROGATORY
viper_noun	Giftschlange_noun	DEROGATORY
virulence_noun	Heftigkeit_noun	OTHER
volatile_adj	unstetig_adj	OTHER
vomit_verb	kotzen_verb	DEROGATORY
vulgar_adj	pöbelhaft_adj	DEROGATORY
wail_verb	wehklagen_verb	OTHER
wane_verb	abflauen_verb	OTHER
wariness_noun	Skepsis_noun	OTHER
warlike_adj	streitbar_adj	OTHER
warped_adj	abartig_adj	DEROGATORY
waste_noun	Verschwendung_noun	OTHER
waste_verb	verschwenden_verb	DEROGATORY
wasteful_adj	unwirtschaftlich_adj	OTHER
wastefulness_noun	Verschwendungssucht_noun	DEROGATORY
wayward_adj	unberechenbar_adj	OTHER
weaken_verb	schwächen_verb	OTHER
weakness_noun	Schwäche_noun	OTHER
weary_verb	ermüden_verb	OTHER
weep_verb	weinen_verb	OTHER
wetback_noun	?	DEROGATORY
whimper_verb	fiepen_verb	OTHER
whine_verb	winseln_verb	DEROGATORY
whore_noun	Hure_noun	DEROGATORY
widespread_adj	weitverbreitet_adj	OTHER
wigger_noun	Möchtegern-Schwarzer_noun	DEROGATORY
wild_adj	wild_adj	OTHER
wilt_verb	abschlaffen_verb	OTHER
wily_adj	verschlagen_adj	OTHER
wince_verb	zusammenzucken_verb	OTHER
withhold_verb	vorenthalten_verb	OTHER
woe_noun	Leid_noun	OTHER
woebegone_adj	kummervoll_adj	OTHER
wolly_noun	?	DEROGATORY
wop_noun	Katzelmacher_noun	DEROGATORY
worried_adj	besorgt_adj	OTHER
worry_noun	Sorge_noun	OTHER
worry_verb	sorgen_verb	OTHER
worsen_verb	verschlechtern_verb	OTHER
worthless_adj	wertlos_adj	DEROGATORY
worthlessness_noun	Wertlosigkeit_noun	OTHER
wound_noun	Wunde_noun	OTHER
wrangle_verb	streiten_verb	OTHER
wreck_noun	Wrack_noun	DEROGATORY
wreck_verb	?	DEROGATORY
wrest_verb	entreißen_verb	OTHER
wrestle_verb	niederringen_verb	OTHER
wrong_verb	benachteiligen_verb	OTHER
wrongful_adj	ungerechtfertigt_adj	OTHER
yarpie_noun	?	DEROGATORY
yawn_noun	Gähnen_noun	OTHER
yawn_verb	gähnen_verb	OTHER
yokel_noun	Bauerntölpel_noun	DEROGATORY
zealot_noun	Fanatiker_noun	DEROGATORY
zigabo_noun	?	DEROGATORY
