#compound	modifier	head	label
beutelabschneider	beutel	abschneider	OTHER
couponabschneider	coupon	abschneider	DEROGATORY
drahtabschneider	draht	abschneider	OTHER
fadenabschneider	faden	abschneider	OTHER
fettabschneider	fett	abschneider	OTHER
gardinenabschneider	gardine	abschneider	DEROGATORY
gedichteabschneider	gedicht	abschneider	OTHER
geldabschneider	geld	abschneider	DEROGATORY
gurgelabschneider	gurgel	abschneider	OTHER
haarabschneider	haar	abschneider	OTHER
halsabschneider	hals	abschneider	DEROGATORY
harfenabschneider	harfe	abschneider	OTHER
kapselabschneider	kapsel	abschneider	OTHER
kehlabschneider	kehl	abschneider	OTHER
kopfabschneider	kopf	abschneider	DEROGATORY
rohrabschneider	rohr	abschneider	OTHER
wortabschneider	wort	abschneider	DEROGATORY
wurstabschneider	wurst	abschneider	OTHER
zigarrenabschneider	zigarre	abschneider	OTHER
zopfabschneider	zopf	abschneider	DEROGATORY
amtsadvokat	amt	advokat	OTHER
armenadvokat	arm	advokat	OTHER
copyright-advokat	copyright	advokat	OTHER
datenschutz-advokat	datenschutz	advokat	OTHER
generaladvokat	general	advokat	OTHER
genetik-advokat	genetik	advokat	OTHER
gerichtadvokat	gericht	advokat	OTHER
hobbyadvokat	hobby	advokat	OTHER
hofgerichtsadvokat	hofgericht	advokat	OTHER
klima-advokat	klima	advokat	OTHER
landgerichtsadvokat	landgericht	advokat	OTHER
nutzeradvokat	nutzer	advokat	OTHER
reformadvokat	reform	advokat	OTHER
sammelklagen-advokat	sammelklage	advokat	OTHER
stadt-advokat	stadt	advokat	OTHER
teufels-advokat	teufel	advokat	OTHER
umweltadvokat	umwelt	advokat	OTHER
vereinadvokat	verein	advokat	OTHER
weinadvokat	wein	advokat	OTHER
winkeladvokat	winkel	advokat	DEROGATORY
akzent-akrobat	akzent	akrobat	OTHER
ballakrobat	ball	akrobat	OTHER
boden-akrobat	boden	akrobat	OTHER
fallschirmakrobat	fallschirm	akrobat	OTHER
feuerakrobat	feuer	akrobat	OTHER
fußballakrobat	fußball	akrobat	OTHER
gastakrobat	gast	akrobat	OTHER
gehirnakrobat	gehirn	akrobat	DEROGATORY
gitarrenakrobat	gitarre	akrobat	OTHER
himmelsakrobat	himmel	akrobat	OTHER
kletterakrobat	klettern	akrobat	OTHER
kraft-akrobat	kraft	akrobat	OTHER
parterre-akrobat	parterre	akrobat	OTHER
raumakrobat	raum	akrobat	OTHER
saiten-akrobat	saite	akrobat	OTHER
stabakrobat	stab	akrobat	OTHER
stelzenakrobat	stelze	akrobat	OTHER
stilakrobat	stil	akrobat	OTHER
stringakrobat	string	akrobat	OTHER
waffen-akrobat	waffe	akrobat	OTHER
feldstein-apostel	feldstein	apostel	OTHER
frankenapostel	franke	apostel	OTHER
friesenapostel	friesen	apostel	OTHER
humanitätsapostel	humanität	apostel	OTHER
jugendapostel	jugend	apostel	OTHER
kapitalismusapostel	kapitalismus	apostel	OTHER
kirchenapostel	kirche	apostel	OTHER
laienapostel	laie	apostel	OTHER
liebesapostel	liebe	apostel	OTHER
moralapostel	moral	apostel	DEROGATORY
reinheitsapostel	reinheit	apostel	OTHER
religionsapostel	religion	apostel	DEROGATORY
schlichtheitsapostel	schlichtheit	apostel	OTHER
sicherheitsapostel	sicherheit	apostel	DEROGATORY
stabilitätsapostel	stabilität	apostel	OTHER
tugendapostel	tugend	apostel	OTHER
umweltapostel	umwelt	apostel	DEROGATORY
unabhängigkeitsapostel	unabhängigkeit	apostel	OTHER
verzichtsapostel	verzicht	apostel	DEROGATORY
wunderapostel	wunder	apostel	OTHER
assoziationsathlet	assoziation	athlet	OTHER
bergathlet	berg	athlet	OTHER
berufsathlet	beruf	athlet	OTHER
bilderbuchathlet	bilderbuch	athlet	OTHER
bronzeathlet	bronze	athlet	OTHER
felsathlet	fels	athlet	OTHER
gesichtsathlet	gesicht	athlet	OTHER
highschool-athlet	highschool	athlet	OTHER
hobbyathlet	hobby	athlet	OTHER
kader-athlet	kader	athlet	OTHER
kampfkunstathlet	kampfkunst	athlet	OTHER
nationalkaderathlet	nationalkader	athlet	OTHER
nrw-athlet	nrw	athlet	OTHER
rollstuhl-athlet	rollstuhl	athlet	OTHER
sand-athlet	sand	athlet	OTHER
schmalspur-athlet	schmalspur	athlet	DEROGATORY
ski-athlet	ski	athlet	OTHER
stammtischathlet	stammtisch	athlet	OTHER
star-athlet	star	athlet	OTHER
wort-athlet	wort	athlet	OTHER
arbeitsspeicher-aufräumer	arbeitsspeicher	aufräumer	OTHER
büro-aufräumer	büro	aufräumer	OTHER
chefaufräumer	chef	aufräumer	OTHER
festplatzaufräumer	festplatz	aufräumer	OTHER
forumsaufräumer	forum	aufräumer	OTHER
gartenaufräumer	garten	aufräumer	OTHER
hausaufräumer	haus	aufräumer	OTHER
kelleraufräumer	keller	aufräumer	OTHER
kunstaufräumer	kunst	aufräumer	OTHER
küchenaufräumer	küche	aufräumer	OTHER
lageraufräumer	lager	aufräumer	OTHER
magenaufräumer	magen	aufräumer	OTHER
mundaufräumer	mund	aufräumer	OTHER
registry-aufräumer	registry	aufräumer	OTHER
schrankaufräumer	schrank	aufräumer	OTHER
schreibtischaufräumer	schreibtisch	aufräumer	DEROGATORY
straßenaufräumer	straße	aufräumer	OTHER
vorurteilsaufräumer	vorurteil	aufräumer	OTHER
waldaufräumer	wald	aufräumer	OTHER
weltaufräumer	welt	aufräumer	DEROGATORY
anzeigenausdrucker	anzeige	ausdrucker	OTHER
bahnkartenselbstausdrucker	bahnkartenselbst	ausdrucker	OTHER
briefausdrucker	brief	ausdrucker	OTHER
buchausdrucker	buch	ausdrucker	OTHER
e-mail-ausdrucker	e-mail	ausdrucker	DEROGATORY
fotoausdrucker	foto	ausdrucker	OTHER
homeausdrucker	home	ausdrucker	OTHER
internetausdrucker	internet	ausdrucker	DEROGATORY
internetseitenausdrucker	internetseite	ausdrucker	OTHER
kommentar-ausdrucker	kommentar	ausdrucker	OTHER
kontoausdrucker	konto	ausdrucker	OTHER
kontoauszugausdrucker	kontoauszug	ausdrucker	OTHER
landkarten-ausdrucker	landkarte	ausdrucker	OTHER
netzausdrucker	netz	ausdrucker	DEROGATORY
poster-ausdrucker	poster	ausdrucker	OTHER
rezeptausdrucker	rezept	ausdrucker	OTHER
seitenausdrucker	seite	ausdrucker	OTHER
walkthroughausdrucker	walkthrough	ausdrucker	DEROGATORY
webseitenausdrucker	webseite	ausdrucker	OTHER
zeitungsausdrucker	zeitung	ausdrucker	OTHER
dorfbacke	dorf	backe	OTHER
elefantenbacke	elefant	backe	OTHER
festbacke	fest	backe	OTHER
feuerbacke	feuer	backe	OTHER
gesichtsbacke	gesicht	backe	OTHER
hamsterbacke	hamster	backe	OTHER
hartmetallbacke	hartmetall	backe	OTHER
hausbacke	haus	backe	OTHER
hinternbacke	hintern	backe	OTHER
kalbsbacke	kalb	backe	OTHER
kinderbacke	kind	backe	OTHER
mausebacke	mausen	backe	OTHER
messingbacke	messing	backe	OTHER
nazibacke	nazi	backe	DEROGATORY
ochsenbacke	ochse	backe	OTHER
plätzchenbacke	plätzchen	backe	OTHER
schmalzbacke	schmalz	backe	DEROGATORY
semmelbacke	semmel	backe	OTHER
sensorbacke	sensor	backe	OTHER
sportbacke	sport	backe	OTHER
carlsbader	carl	bader	OTHER
dorfbader	dorf	bader	OTHER
karlsbader	karl	bader	OTHER
klosterbader	kloster	bader	OTHER
kostenbader	kosten	bader	OTHER
landbader	land	bader	OTHER
lustbader	lust	bader	OTHER
marienbader	maria	bader	OTHER
naturbader	natur	bader	OTHER
saunabader	sauna	bader	OTHER
schlangenbader	schlange	bader	OTHER
schnorchelbader	schnorchel	bader	DEROGATORY
segelbader	segel	bader	OTHER
solarbader	solar	bader	OTHER
sonnenbader	sonne	bader	OTHER
spaßbader	spaß	bader	OTHER
thermalbader	thermal	bader	DEROGATORY
wildbader	wild	bader	OTHER
winterbader	winter	bader	OTHER
wurmbader	wurm	bader	OTHER
abfertigungsbaracke	abfertigung	baracke	OTHER
arbeitsdienstbaracke	arbeitsdienst	baracke	OTHER
armeebaracke	armee	baracke	OTHER
bauarbeiterbaracke	bauarbeiter	baracke	OTHER
bürobaracke	büro	baracke	OTHER
entlassungsbaracke	entlassung	baracke	OTHER
garderobenbaracke	garderobe	baracke	OTHER
geburtsbaracke	geburt	baracke	OTHER
gesichtsbaracke	gesicht	baracke	DEROGATORY
heeresbaracke	heer	baracke	OTHER
juden-baracke	jude	baracke	OTHER
kinderbaracke	kind	baracke	OTHER
krankenbaracke	kranke	baracke	OTHER
lagerbaracke	lager	baracke	OTHER
militär-baracke	militär	baracke	OTHER
plattenbaubaracke	plattenbau	baracke	OTHER
soldatenbaracke	soldat	baracke	OTHER
unterrichtsbaracke	unterricht	baracke	OTHER
wehrmachtsbaracke	wehrmacht	baracke	OTHER
werkstattbaracke	werkstatt	baracke	OTHER
chefbastler	chef	bastler	OTHER
computer-bastler	computer	bastler	OTHER
drehbuchbastler	drehbuch	bastler	OTHER
fahrradbastler	fahrrad	bastler	OTHER
fischer-bastler	fischer	bastler	OTHER
gartenbastler	garten	bastler	OTHER
gelegenheitsbastler	gelegenheit	bastler	OTHER
hardware-bastler	hardware	bastler	OTHER
hobbybastler	hobby	bastler	OTHER
klang-bastler	klang	bastler	OTHER
layout-bastler	layout	bastler	OTHER
leichen-bastler	leiche	bastler	OTHER
methoden-bastler	methode	bastler	OTHER
modellbastler	modell	bastler	OTHER
multimediabastler	multimedia	bastler	OTHER
objektbastler	objekt	bastler	OTHER
spielebastler	spiel	bastler	OTHER
sprengsatzbastler	sprengsatz	bastler	OTHER
strohsternbastler	strohstern	bastler	DEROGATORY
web-bastler	web	bastler	OTHER
bodenbeißer	boden	beißer	OTHER
bohlenbeißer	bohle	beißer	OTHER
bordsteinbeißer	bordstein	beißer	OTHER
brotbeißer	brot	beißer	OTHER
bullenbeißer	bulle	beißer	OTHER
bärenbeißer	bär	beißer	OTHER
gitterbeißer	gitter	beißer	OTHER
hennenbeißer	henne	beißer	OTHER
kehlbeißer	kehl	beißer	DEROGATORY
kniebeißer	knie	beißer	DEROGATORY
knochenbeißer	knochen	beißer	OTHER
menschenbeißer	mensch	beißer	OTHER
perlbeißer	perl	beißer	OTHER
schlammbeißer	schlamm	beißer	OTHER
schleimbeißer	schleim	beißer	OTHER
steinbeißer	stein	beißer	OTHER
wadenbeißer	wade	beißer	DEROGATORY
zitronenbeißer	zitrone	beißer	OTHER
zungenbeißer	zunge	beißer	OTHER
ärmelbeißer	ärmel	beißer	DEROGATORY
bot-benutzer	bot	benutzer	OTHER
campingplatzbenutzer	campingplatz	benutzer	OTHER
digitalkamerabenutzer	digitalkamera	benutzer	OTHER
gleisbenutzer	gleis	benutzer	OTHER
interfacebenutzer	interface	benutzer	OTHER
internetbenutzer	internet	benutzer	OTHER
laptop-benutzer	laptop	benutzer	OTHER
modembenutzer	modem	benutzer	OTHER
mp3-benutzer	mp3	benutzer	OTHER
netzkunstbenutzer	netzkunst	benutzer	OTHER
opera-benutzer	opus	benutzer	OTHER
papyrus-benutzer	papyrus	benutzer	OTHER
planbenutzer	plan	benutzer	OTHER
radwegebenutzer	radweg	benutzer	OTHER
seilbahnbenutzer	seilbahn	benutzer	OTHER
stadtteilbenutzer	stadtteil	benutzer	OTHER
stegbenutzer	steg	benutzer	OTHER
taschenrechnerbenutzer	taschenrechner	benutzer	DEROGATORY
tastatur-benutzer	tastatur	benutzer	OTHER
tauschbörsen-benutzer	tauschbörse	benutzer	OTHER
badewannen-besitzer	badewanne	besitzer	OTHER
budenbesitzer	bude	besitzer	OTHER
doggen-besitzer	dogge	besitzer	OTHER
gartenbesitzer	garten	besitzer	OTHER
geldscheinbesitzer	geldschein	besitzer	OTHER
handy-besitzer	handy	besitzer	OTHER
haushaltsbesitzer	haushalt	besitzer	OTHER
hypothekenbesitzer	hypothek	besitzer	OTHER
jazzclub-besitzer	jazzclub	besitzer	OTHER
kapital-besitzer	kapital	besitzer	OTHER
monatskartenbesitzer	monatskarte	besitzer	DEROGATORY
parkplatz-besitzer	parkplatz	besitzer	OTHER
quelle-besitzer	quelle	besitzer	OTHER
rüdenbesitzer	rüde	besitzer	OTHER
salinenbesitzer	saline	besitzer	OTHER
sägemühlenbesitzer	sägemühle	besitzer	OTHER
teambesitzer	team	besitzer	OTHER
teehausbesitzer	teehaus	besitzer	OTHER
warenhausbesitzer	warenhaus	besitzer	OTHER
wohnrecht-besitzer	wohnrecht	besitzer	OTHER
armenbesucher	arm	besucher	OTHER
dresdenbesucher	dresden	besucher	OTHER
fachbesucher	fach	besucher	OTHER
freizeitbesucher	freizeit	besucher	OTHER
fußballplatzbesucher	fußballplatz	besucher	OTHER
galerie-besucher	galerie	besucher	OTHER
gottesdienstbesucher	gottesdienst	besucher	OTHER
großveranstaltungs-besucher	großveranstaltung	besucher	OTHER
harz-besucher	harz	besucher	OTHER
kairo-besucher	kairo	besucher	OTHER
kinobesucher	kino	besucher	OTHER
konzertbesucher	konzert	besucher	OTHER
messebesucher	messe	besucher	OTHER
opernballbesucher	opernball	besucher	OTHER
rangbesucher	rang	besucher	OTHER
rostock-besucher	rostock	besucher	OTHER
stammbesucher	stamm	besucher	OTHER
stift-besucher	stift	besucher	OTHER
streichelzoobesucher	streichelzoo	besucher	DEROGATORY
suchmaschinenbesucher	suchmaschine	besucher	OTHER
akropolis-betrachter	akropolis	betrachter	OTHER
bilanzbetrachter	bilanz	betrachter	OTHER
bild-betrachter	bild	betrachter	OTHER
buchbetrachter	buch	betrachter	OTHER
film-betrachter	film	betrachter	OTHER
hilfe-betrachter	hilfe	betrachter	OTHER
himmelsbetrachter	himmel	betrachter	OTHER
homepage-betrachter	homepage	betrachter	OTHER
internetbetrachter	internet	betrachter	OTHER
landschaftsbetrachter	landschaft	betrachter	DEROGATORY
linsenbetrachter	linse	betrachter	OTHER
literaturbetrachter	literatur	betrachter	OTHER
marsbetrachter	mars	betrachter	OTHER
naturbetrachter	natur	betrachter	OTHER
pdf-betrachter	pdf	betrachter	OTHER
schachbetrachter	schach	betrachter	OTHER
szenebetrachter	szene	betrachter	OTHER
veränderungs-betrachter	veränderung	betrachter	OTHER
videobetrachter	video	betrachter	OTHER
zufallsbetrachter	zufall	betrachter	OTHER
beinbeuger	bein	beuger	OTHER
daumenbeuger	daumen	beuger	OTHER
ellenbogenbeuger	ellenbogen	beuger	OTHER
fingerbeuger	finger	beuger	OTHER
großzehenbeuger	großzehen	beuger	OTHER
halsbeuger	hals	beuger	OTHER
handbeuger	hand	beuger	OTHER
handgelenksbeuger	handgelenk	beuger	OTHER
hüftbeuger	hüft	beuger	OTHER
kniebeuger	knie	beuger	OTHER
kniegelenksbeuger	kniegelenk	beuger	OTHER
langfingerbeuger	langfinger	beuger	OTHER
oberarmbeuger	oberarm	beuger	OTHER
oberschenkelbeuger	oberschenkel	beuger	OTHER
rechtsbeuger	recht	beuger	DEROGATORY
rückenbeuger	rücken	beuger	OTHER
unterarmbeuger	unterarm	beuger	OTHER
unterschenkelbeuger	unterschenkel	beuger	OTHER
wahrheitsbeuger	wahrheit	beuger	DEROGATORY
zehenbeuger	zeh	beuger	OTHER
balkenbieger	balken	bieger	DEROGATORY
ballonbieger	ballon	bieger	OTHER
bananenbieger	banane	bieger	DEROGATORY
betonstahlbieger	betonstahl	bieger	OTHER
blechbieger	blech	bieger	OTHER
drahtbieger	draht	bieger	OTHER
eichenbieger	eiche	bieger	OTHER
eisenbieger	eisen	bieger	OTHER
gabelbieger	gabel	bieger	OTHER
glasbieger	glas	bieger	OTHER
knochenbieger	knochen	bieger	OTHER
löffelbieger	löffel	bieger	OTHER
metallbieger	metall	bieger	OTHER
plankenbieger	planke	bieger	OTHER
präzisionsbieger	präzision	bieger	OTHER
regenbogenbieger	regenbogen	bieger	OTHER
rohrbieger	rohr	bieger	OTHER
schnörkelbieger	schnörkel	bieger	OTHER
stahlbieger	stahl	bieger	OTHER
winkelbieger	winkel	bieger	OTHER
augenbläser	auge	bläser	OTHER
ballon-bläser	ballon	bläser	OTHER
berg-bläser	berg	bläser	OTHER
blechbläser	blech	bläser	OTHER
bonbonbläser	bonbon	bläser	OTHER
dekanatsbläser	dekanat	bläser	OTHER
dudelsack-bläser	dudelsack	bläser	OTHER
glas-bläser	glas	bläser	OTHER
horn-bläser	horn	bläser	OTHER
lerchenbläser	lerche	bläser	OTHER
luftbläser	luft	bläser	OTHER
mühlenbläser	mühle	bläser	OTHER
nachwuchsbläser	nachwuchs	bläser	OTHER
puderzuckerbläser	puderzucker	bläser	DEROGATORY
retorten-bläser	retorte	bläser	OTHER
schalmeibläser	schalmei	bläser	OTHER
schönbuchbläser	schönbuch	bläser	OTHER
trompetenbläser	trompete	bläser	OTHER
trübsalbläser	trübsal	bläser	DEROGATORY
wasserbläser	wasser	bläser	OTHER
ampelbohrer	ampel	bohrer	OTHER
apfelbohrer	apfel	bohrer	OTHER
diamantbohrer	diamant	bohrer	OTHER
dosenbohrer	dose	bohrer	OTHER
dünnbrettbohrer	dünnbrett	bohrer	DEROGATORY
fensterbohrer	fenster	bohrer	OTHER
fingerbohrer	finger	bohrer	OTHER
fremdkörperbohrer	fremdkörper	bohrer	OTHER
hartmetall-bohrer	hartmetall	bohrer	OTHER
holzbohrer	holz	bohrer	OTHER
knochenbohrer	knochen	bohrer	OTHER
kornbohrer	korn	bohrer	OTHER
kunststoffbohrer	kunststoff	bohrer	OTHER
planetenbohrer	planet	bohrer	OTHER
plasmabohrer	plasma	bohrer	OTHER
schlagbohrer	schlag	bohrer	OTHER
schlangenbohrer	schlange	bohrer	OTHER
tunnelbohrer	tunnel	bohrer	OTHER
turbinenbohrer	turbine	bohrer	OTHER
zahnarztbohrer	zahnarzt	bohrer	OTHER
armbrust-bolzen	armbrust	bolzen	OTHER
demenzbolzen	demenz	bolzen	DEROGATORY
donnerbolzen	donner	bolzen	OTHER
druckbolzen	druck	bolzen	OTHER
eisenbolzen	eisen	bolzen	OTHER
intelligenzbolzen	intelligenz	bolzen	DEROGATORY
konditionsbolzen	kondition	bolzen	OTHER
lagerbolzen	lager	bolzen	OTHER
musikbolzen	musik	bolzen	OTHER
nervbolzen	nerv	bolzen	DEROGATORY
panzerbolzen	panzer	bolzen	OTHER
penetranzbolzen	penetranz	bolzen	DEROGATORY
pfostenbolzen	pfosten	bolzen	OTHER
pilzbolzen	pilz	bolzen	OTHER
rotorbolzen	rotor	bolzen	OTHER
schussbolzen	schuss	bolzen	OTHER
sicherungsbolzen	sicherung	bolzen	OTHER
sympathiebolzen	sympathie	bolzen	OTHER
temperamentsbolzen	temperament	bolzen	OTHER
tür-bolzen	türe	bolzen	OTHER
asphaltbraten	asphalt	braten	OTHER
eberbraten	eber	braten	OTHER
fleischbraten	fleisch	braten	OTHER
geflügelbraten	geflügel	braten	OTHER
hexenbraten	hexe	braten	OTHER
hirtenbraten	hirte	braten	OTHER
jungfrauenbraten	jungfrau	braten	OTHER
kaninchenbraten	kaninchen	braten	OTHER
lendenbraten	lende	braten	OTHER
löwenbraten	löwe	braten	OTHER
maulwurfsbraten	maulwurf	braten	OTHER
ochsenbraten	ochse	braten	OTHER
salzbraten	salz	braten	OTHER
satansbraten	satan	braten	DEROGATORY
schlupfbraten	schlupf	braten	OTHER
schweinsbraten	schwein	braten	OTHER
schwenkbraten	schwenk	braten	OTHER
spießbraten	spieß	braten	OTHER
truthahn-braten	truthahn	braten	OTHER
weihnachts-braten	weihnacht	braten	OTHER
akkordbrecher	akkord	brecher	OTHER
austernbrecher	auster	brecher	OTHER
ballbrecher	ball	brecher	OTHER
bunkerbrecher	bunker	brecher	OTHER
dimensionsbrecher	dimension	brecher	OTHER
eckenbrecher	ecke	brecher	OTHER
eisenbrecher	eisen	brecher	OTHER
embargobrecher	embargo	brecher	OTHER
gesetzbrecher	gesetz	brecher	OTHER
knochenbrecher	knochen	brecher	OTHER
kostenbrecher	kosten	brecher	OTHER
menschenrechtsbrecher	menschenrecht	brecher	DEROGATORY
rechtsbrecher	recht	brecher	OTHER
rückgratbrecher	rückgrat	brecher	OTHER
sorgenbrecher	sorge	brecher	OTHER
stahlenbrecher	stehlen	brecher	OTHER
streikbrecher	streik	brecher	OTHER
tarifbrecher	tarif	brecher	OTHER
tarifvertragsbrecher	tarifvertrag	brecher	OTHER
vertrauensbrecher	vertrauen	brecher	OTHER
abraumbrocken	abraum	brocken	OTHER
bernsteinbrocken	bernstein	brocken	OTHER
elastomerbrocken	elastomer	brocken	OTHER
fleischbrocken	fleisch	brocken	OTHER
futterbrocken	futter	brocken	OTHER
gedankenbrocken	gedanke	brocken	OTHER
gemsbrocken	gems	brocken	OTHER
geröllbrocken	geröll	brocken	OTHER
gesprächsbrocken	gespräch	brocken	OTHER
holzbrocken	holz	brocken	OTHER
kohlebrocken	kohle	brocken	OTHER
kotzbrocken	kotzen	brocken	DEROGATORY
ringbrocken	ring	brocken	OTHER
sandsteinbrocken	sandstein	brocken	OTHER
schneebrocken	schnee	brocken	OTHER
speckbrocken	speck	brocken	OTHER
speisebrocken	speise	brocken	OTHER
systembrocken	system	brocken	OTHER
teigbrocken	teig	brocken	OTHER
trümmer-brocken	trümmer	brocken	OTHER
blaubarschbube	blaubarsch	bube	OTHER
eichel-bube	eichel	bube	OTHER
flügelbube	flügel	bube	OTHER
herzbube	herz	bube	OTHER
höllenbube	hölle	bube	OTHER
judenbube	jude	bube	OTHER
kaminfegerbube	kaminfeger	bube	OTHER
karo-bube	karo	bube	OTHER
kreuzbube	kreuz	bube	OTHER
milchbube	milch	bube	DEROGATORY
mordbube	mord	bube	OTHER
müllerbube	müller	bube	OTHER
sandkastenbube	sandkasten	bube	DEROGATORY
schusterbube	schuster	bube	OTHER
schäferbube	schäfer	bube	OTHER
spatzenbube	spatz	bube	OTHER
taktstock-bube	taktstock	bube	OTHER
terrorbube	terror	bube	DEROGATORY
trumpfbube	trumpf	bube	OTHER
wetterbube	wetter	bube	OTHER
ameisenbär	ameise	bär	OTHER
brillenbär	brille	bär	OTHER
dreckbär	dreck	bär	DEROGATORY
feuerbär	feuer	bär	OTHER
flechtenbär	flechte	bär	OTHER
fliegerbär	flieger	bär	OTHER
geisterbär	geist	bär	OTHER
gold-bär	gold	bär	OTHER
höhlenbär	höhle	bär	OTHER
kochbär	koch	bär	OTHER
kunststoffbär	kunststoff	bär	OTHER
lippenbär	lippe	bär	OTHER
luxusbär	luxus	bär	OTHER
nasenbär	nase	bär	OTHER
plüschbär	plüsch	bär	OTHER
problembär	problem	bär	OTHER
reflektorbär	reflektor	bär	OTHER
strohbär	stroh	bär	OTHER
teddybär	teddy	bär	OTHER
zirkusbär	zirkus	bär	OTHER
anzugbügler	anzug	bügler	OTHER
berufsbügler	beruf	bügler	OTHER
dampfbügler	dampf	bügler	OTHER
dampfdruckbügler	dampfdruck	bügler	OTHER
dampfhammerbügler	dampfhammer	bügler	OTHER
faltenbügler	falte	bügler	OTHER
gelegenheitsbügler	gelegenheit	bügler	OTHER
hautfaltenbügler	hautfalte	bügler	OTHER
heimbügler	heim	bügler	OTHER
hochdruckbügler	hochdruck	bügler	OTHER
hosenbügler	hose	bügler	OTHER
jeansbügler	jeans	bügler	DEROGATORY
krawattenbügler	krawatte	bügler	OTHER
mengenbügler	menge	bügler	OTHER
nackenbügler	nacken	bügler	OTHER
pixelbügler	pixel	bügler	OTHER
reisebügler	reise	bügler	OTHER
sockenbügler	socke	bügler	DEROGATORY
unterhosenbügler	unterhose	bügler	DEROGATORY
walzenbügler	walze	bügler	OTHER
eu-staatsbürger	eustaat	bürger	OTHER
gemeindebürger	gemeinde	bürger	OTHER
gemeinschaftsbürger	gemeinschaft	bürger	OTHER
gesellschaftsbürger	gesellschaft	bürger	OTHER
glaubensbürger	glaube	bürger	OTHER
hongkongbürger	hongkong	bürger	OTHER
landesbürger	land	bürger	OTHER
landkreisbürger	landkreis	bürger	OTHER
leistungsbürger	leistung	bürger	OTHER
marktbürger	markt	bürger	OTHER
nationalbürger	national	bürger	OTHER
normbürger	norm	bürger	OTHER
protestbürger	protest	bürger	OTHER
reichsbürger	reich	bürger	OTHER
spießbürger	spieß	bürger	DEROGATORY
staatsbürger	staat	bürger	OTHER
usa-bürger	usa	bürger	OTHER
weizenbürger	weizen	bürger	OTHER
weißbierbürger	weißbier	bürger	OTHER
zuschauer-bürger	zuschauer	bürger	OTHER
borstenbürste	borste	bürste	OTHER
designer-bürste	designer	bürste	OTHER
erwachsenenbürste	erwachsene	bürste	OTHER
gemüsebürste	gemüse	bürste	OTHER
hautbürste	haut	bürste	OTHER
kleiderbürste	kleid	bürste	OTHER
kohlebürste	kohle	bürste	OTHER
langhaarbürste	langhaar	bürste	OTHER
lasurbürste	lasur	bürste	OTHER
malerbürste	maler	bürste	OTHER
plattenbürste	platte	bürste	OTHER
pudelbürste	pudel	bürste	OTHER
rotationsbürste	rotation	bürste	OTHER
saugerbürste	sauger	bürste	OTHER
schuhbürste	schuh	bürste	OTHER
staubbürste	staub	bürste	OTHER
walzenbürste	walze	bürste	OTHER
waschanlagenbürste	waschanlage	bürste	OTHER
wichsbürste	wichsen	bürste	DEROGATORY
zauberbürste	zauber	bürste	OTHER
abfallcharge	abfall	charge	OTHER
beamtencharge	beamter	charge	OTHER
erntecharge	ernte	charge	OTHER
frachtcharge	fracht	charge	OTHER
futter-charge	futter	charge	OTHER
futtermittelcharge	futtermittel	charge	OTHER
getreidecharge	getreide	charge	OTHER
impfstoffcharge	impfstoff	charge	OTHER
insulincharge	insulin	charge	OTHER
kavalleriecharge	kavallerie	charge	OTHER
knallcharge	knall	charge	DEROGATORY
minutencharge	minute	charge	OTHER
offizierscharge	offizier	charge	OTHER
parteicharge	partei	charge	OTHER
petroleumcharge	petroleum	charge	OTHER
schlacht-charge	schlacht	charge	OTHER
schurkencharge	schurke	charge	OTHER
stasi-charge	stasi	charge	OTHER
vatikan-charge	vatikan	charge	OTHER
verwaltungscharge	verwaltung	charge	OTHER
bierchecker	bier	checker	OTHER
bug-checker	bug	checker	OTHER
drogenchecker	droge	checker	OTHER
e-mail-checker	e-mail	checker	OTHER
elite-checker	elite	checker	OTHER
factchecker	fact	checker	OTHER
gebäude-checker	gebäude	checker	OTHER
info-checker	info	checker	OTHER
ketten-checker	kette	checker	OTHER
konzert-checker	konzert	checker	OTHER
ladychecker	lady	checker	OTHER
link-checker	link	checker	OTHER
model-checker	model	checker	OTHER
nullchecker	null	checker	DEROGATORY
promille-checker	promille	checker	OTHER
sms-checker	sms	checker	OTHER
solarchecker	solar	checker	OTHER
virus-checker	virus	checker	OTHER
waffenchecker	waffe	checker	OTHER
zirkuschecker	zirkus	checker	OTHER
akrobatenclown	akrobat	clown	OTHER
bundesclown	bund	clown	DEROGATORY
bühnenclown	bühne	clown	OTHER
diplomclown	diplom	clown	OTHER
endorphin-clown	endorphin	clown	DEROGATORY
geburtstagsclown	geburtstag	clown	OTHER
hip-hop-clown	hiphop	clown	OTHER
horror-clown	horror	clown	OTHER
killerclown	killer	clown	OTHER
kinderclown	kind	clown	OTHER
kletter-clown	klettern	clown	OTHER
krankenhaus-clown	krankenhaus	clown	OTHER
kreuz-clown	kreuz	clown	OTHER
königsclown	könig	clown	DEROGATORY
partyclown	party	clown	OTHER
pausenclown	pause	clown	DEROGATORY
tütenclown	tüte	clown	OTHER
wurfclown	wurf	clown	OTHER
zauberclown	zauber	clown	OTHER
zirkusclown	zirkus	clown	OTHER
berufsdenker	beruf	denker	OTHER
chefdenker	chef	denker	OTHER
csu-denker	csu	denker	OTHER
durchschnittsdenker	durchschnitt	denker	DEROGATORY
freiheitsdenker	freiheit	denker	OTHER
friedensdenker	frieden	denker	OTHER
gesellschaftsdenker	gesellschaft	denker	OTHER
gottdenker	gott	denker	OTHER
jahrtausenddenker	jahrtausend	denker	OTHER
kulturdenker	kultur	denker	OTHER
managementdenker	management	denker	OTHER
politikdenker	politik	denker	OTHER
rassendenker	rasse	denker	OTHER
reformdenker	reform	denker	OTHER
reinkarnationsdenker	reinkarnation	denker	OTHER
schachdenker	schach	denker	OTHER
schmalspurdenker	schmalspur	denker	DEROGATORY
stardenker	star	denker	OTHER
zeit-denker	zeit	denker	OTHER
zukunftsdenker	zukunft	denker	OTHER
bohrmaschinendieb	bohrmaschine	dieb	OTHER
bröseldieb	brösel	dieb	OTHER
dieseldieb	diesel	dieb	OTHER
dschungeldieb	dschungel	dieb	OTHER
feuerdieb	feuer	dieb	OTHER
gepäckdieb	gepäck	dieb	OTHER
getränkedieb	getränk	dieb	OTHER
handtaschendieb	handtasche	dieb	OTHER
honigdieb	honig	dieb	OTHER
kreditkartendieb	kreditkarte	dieb	OTHER
magnesiumdieb	magnesium	dieb	OTHER
paketdieb	paket	dieb	OTHER
passwort-dieb	passwort	dieb	OTHER
pferdedieb	pferd	dieb	OTHER
seelendieb	seele	dieb	OTHER
software-dieb	software	dieb	OTHER
süßigkeitendieb	süßigkeit	dieb	OTHER
tagedieb	tag	dieb	DEROGATORY
tannenbaumdieb	tannenbaum	dieb	OTHER
zukunftsdieb	zukunft	dieb	DEROGATORY
atomdrache	atom	drache	OTHER
baby-drache	baby	drache	OTHER
bernstein-drache	bernstein	drache	OTHER
edelsteindrache	edelstein	drache	OTHER
feendrache	fee	drache	OTHER
hausdrache	haus	drache	DEROGATORY
himmeldrache	himmel	drache	OTHER
kaiserdrache	kaiser	drache	OTHER
karatedrache	karate	drache	OTHER
kleinkunstdrache	kleinkunst	drache	OTHER
meerdrache	meer	drache	OTHER
monsterdrache	monster	drache	OTHER
mostdrache	most	drache	OTHER
neujahrsdrache	neujahr	drache	OTHER
schneedrache	schnee	drache	OTHER
seidendrache	seide	drache	OTHER
spielzeugdrache	spielzeug	drache	OTHER
taschen-drache	tasche	drache	OTHER
vorzimmerdrache	vorzimmer	drache	DEROGATORY
wasserdrache	wasser	drache	OTHER
abgasdreck	abgas	dreck	OTHER
affendreck	affe	dreck	OTHER
autodreck	auto	dreck	OTHER
castingdreck	casting	dreck	DEROGATORY
dezemberdreck	dezember	dreck	OTHER
einheitsdreck	einheit	dreck	OTHER
gedankendreck	gedanke	dreck	OTHER
katzendreck	katze	dreck	OTHER
konservierungsdreck	konservierung	dreck	OTHER
milbendreck	milbe	dreck	OTHER
moslemdreck	moslem	dreck	DEROGATORY
nazidreck	nazi	dreck	DEROGATORY
pixeldreck	pixel	dreck	OTHER
rattendreck	ratte	dreck	OTHER
sensordreck	sensor	dreck	OTHER
sound-dreck	sound	dreck	OTHER
startdreck	start	dreck	OTHER
strahlendreck	strahl	dreck	OTHER
verkehrsdreck	verkehr	dreck	OTHER
weltraumdreck	weltraum	dreck	OTHER
bohnendrescher	bohne	drescher	OTHER
dampfdrescher	dampf	drescher	OTHER
felldrescher	fell	drescher	DEROGATORY
getreidedrescher	getreide	drescher	OTHER
hochleistungsdrescher	hochleistung	drescher	OTHER
hülsendrescher	hülse	drescher	OTHER
korndrescher	korn	drescher	OTHER
lohndrescher	lohn	drescher	OTHER
maisdrescher	mais	drescher	OTHER
parolendrescher	parole	drescher	DEROGATORY
phrasendrescher	phrase	drescher	DEROGATORY
platitüdendrescher	platitüde	drescher	DEROGATORY
rotordrescher	rotor	drescher	OTHER
scheffeldrescher	scheffel	drescher	OTHER
scheunendrescher	scheune	drescher	OTHER
schüttlerdrescher	schüttler	drescher	OTHER
stiftendrescher	stift	drescher	OTHER
strohdrescher	stroh	drescher	OTHER
tabakdrescher	tabak	drescher	OTHER
zungendrescher	zunge	drescher	DEROGATORY
abenddrossel	abend	drossel	OTHER
ameisendrossel	ameise	drossel	OTHER
begrenzungsdrossel	begrenzung	drossel	OTHER
einsiedlerdrossel	einsiedler	drossel	OTHER
feigendrossel	feige	drossel	OTHER
frequenzweichendrossel	frequenzweiche	drossel	OTHER
gleisdrossel	gleis	drossel	OTHER
lärmdrossel	lärm	drossel	OTHER
misteldrossel	mistel	drossel	OTHER
motordrossel	motor	drossel	OTHER
ringdrossel	ring	drossel	OTHER
rücklaufdrossel	rücklauf	drossel	OTHER
schnapsdrossel	schnaps	drossel	DEROGATORY
speicherdrossel	speicher	drossel	OTHER
spottdrossel	spott	drossel	OTHER
steindrossel	stein	drossel	OTHER
wacholderdrossel	wacholder	drossel	OTHER
wanddrossel	wand	drossel	OTHER
wanderdrossel	wandern	drossel	OTHER
weindrossel	wein	drossel	OTHER
daumendrücker	daumen	drücker	OTHER
dosendrücker	dose	drücker	OTHER
drüsendrücker	drüse	drücker	OTHER
garagendrücker	garage	drücker	OTHER
jersey-drücker	jersey	drücker	OTHER
kartoffeldrücker	kartoffel	drücker	OTHER
knopfdrücker	knopf	drücker	OTHER
knöpfchendrücker	knöpfchen	drücker	OTHER
kostendrücker	kosten	drücker	OTHER
kursdrücker	kurs	drücker	OTHER
leistungsdrücker	leistung	drücker	OTHER
lohndrücker	lohn	drücker	DEROGATORY
muskeldrücker	muskel	drücker	OTHER
riesendrücker	riese	drücker	OTHER
sonnendrücker	sonne	drücker	OTHER
spätzledrücker	spätzle	drücker	OTHER
tastendrücker	taste	drücker	OTHER
tränendrüsendrücker	tränendrüse	drücker	DEROGATORY
tubendrücker	tube	drücker	OTHER
zeitschriftendrücker	zeitschrift	drücker	DEROGATORY
brandschutzerzieher	brandschutz	erzieher	OTHER
chorerzieher	chor	erzieher	OTHER
facherzieher	fach	erzieher	OTHER
friedenserzieher	frieden	erzieher	OTHER
geschlechtserzieher	geschlecht	erzieher	OTHER
hort-erzieher	hort	erzieher	OTHER
hundeerzieher	hund	erzieher	OTHER
internatserzieher	internat	erzieher	OTHER
kindergartenerzieher	kindergarten	erzieher	OTHER
kita-erzieher	kita	erzieher	OTHER
knabenerzieher	knabe	erzieher	OTHER
kocherzieher	koch	erzieher	OTHER
mädchenerzieher	mädchen	erzieher	OTHER
orchestererzieher	orchester	erzieher	OTHER
priestererzieher	priester	erzieher	OTHER
teilzeiterzieher	teilzeit	erzieher	OTHER
umwelterzieher	umwelt	erzieher	OTHER
verkehrserzieher	verkehr	erzieher	DEROGATORY
werkerzieher	werk	erzieher	OTHER
zwangerzieher	zwang	erzieher	OTHER
bananenesser	banane	esser	OTHER
beilagenesser	beilage	esser	DEROGATORY
brotesser	brot	esser	OTHER
eieresser	ei	esser	OTHER
fischesser	fisch	esser	OTHER
fleischesser	fleisch	esser	OTHER
frustesser	frust	esser	OTHER
kartoffelesser	kartoffel	esser	OTHER
kotesser	kot	esser	DEROGATORY
kuchenesser	kuchen	esser	OTHER
lichtesser	licht	esser	OTHER
müsliesser	müsli	esser	DEROGATORY
obstesser	obst	esser	OTHER
pflanzenesser	pflanze	esser	OTHER
popelesser	popel	esser	DEROGATORY
schokoriegelesser	schokoriegel	esser	OTHER
schweinefleischesser	schweinefleisch	esser	OTHER
stressesser	stress	esser	OTHER
testesser	test	esser	OTHER
weißbrotesser	weißbrot	esser	OTHER
bergfahrer	berg	fahrer	OTHER
gelegenheitsfahrer	gelegenheit	fahrer	OTHER
hafenfahrer	hafen	fahrer	OTHER
jahrhundert-fahrer	jahrhundert	fahrer	OTHER
jetskifahrer	jetski	fahrer	OTHER
kurierfahrer	kurier	fahrer	OTHER
peugeot-fahrer	peugeot	fahrer	OTHER
polenfahrer	polen	fahrer	OTHER
schönwetterfahrer	schönwetter	fahrer	DEROGATORY
seerfahrer	seer	fahrer	OTHER
solarfahrer	solar	fahrer	OTHER
sommerfahrer	sommer	fahrer	OTHER
sonderrechtsfahrer	sonderrecht	fahrer	OTHER
straßenbahnfahrer	straßenbahn	fahrer	OTHER
subarufahrer	subaru	fahrer	OTHER
ungarnfahrer	ungarn	fahrer	OTHER
veteranenfahrer	veteran	fahrer	OTHER
weltumfahrer	weltum	fahrer	OTHER
windenfahrer	winde	fahrer	OTHER
zweiradfahrer	zweirad	fahrer	OTHER
bananenfalter	banane	falter	OTHER
birkenfalter	birke	falter	OTHER
bonusfalter	bonus	falter	OTHER
feuerfalter	feuer	falter	OTHER
kampffalter	kampf	falter	OTHER
kohlschaben-falter	kohlschabe	falter	OTHER
ligusterfalter	liguster	falter	OTHER
malven-würfelfleckfalter	malvenwürfelfleck	falter	OTHER
passionsblumenfalter	passionsblume	falter	OTHER
perlenfalter	perle	falter	OTHER
pfauenfalter	pfau	falter	OTHER
schneckenfalter	schnecke	falter	OTHER
segelfalter	segel	falter	OTHER
seidenfalter	seide	falter	OTHER
seminarfalter	seminar	falter	OTHER
serviettenfalter	serviette	falter	OTHER
spannerfalter	spanner	falter	OTHER
zeitungsfalter	zeitung	falter	DEROGATORY
zitronenfalter	zitrone	falter	OTHER
zwergfalter	zwerg	falter	OTHER
akademie-fasching	akademie	fasching	OTHER
bordellfasching	bordell	fasching	OTHER
dekanatsfasching	dekanat	fasching	OTHER
dorffasching	dorf	fasching	OTHER
eis-fasching	eis	fasching	OTHER
frauenfasching	frau	fasching	OTHER
gesichtsfasching	gesicht	fasching	DEROGATORY
keller-fasching	keller	fasching	OTHER
kindergarten-fasching	kindergarten	fasching	OTHER
klinikfasching	klinik	fasching	OTHER
klubfasching	klub	fasching	OTHER
mensafasching	mensa	fasching	OTHER
ministrantenfasching	ministrant	fasching	OTHER
pudelfasching	pudel	fasching	OTHER
rockfasching	rock	fasching	OTHER
rollenfasching	rolle	fasching	OTHER
sommerfasching	sommer	fasching	OTHER
sängerfasching	sänger	fasching	OTHER
weihnachtfasching	weihnacht	fasching	OTHER
wohnheim-fasching	wohnheim	fasching	OTHER
bimsfeile	bimsen	feile	OTHER
carbonpfeile	carbonp	feile	OTHER
drehbankfeile	drehbank	feile	OTHER
dreiecksfeile	dreieck	feile	OTHER
edelstahlfeile	edelstahl	feile	OTHER
eierfeile	ei	feile	DEROGATORY
eisenfeile	eisen	feile	OTHER
hakenfeile	haken	feile	OTHER
holzfeile	holz	feile	OTHER
hornhautfeile	hornhaut	feile	OTHER
korkfeile	kork	feile	OTHER
krallenfeile	kralle	feile	OTHER
kristallfeile	kristall	feile	OTHER
metallfeile	metall	feile	OTHER
nadelfeile	nadel	feile	OTHER
sandfeile	sand	feile	OTHER
saphirfeile	saphir	feile	OTHER
scherenfeile	schere	feile	OTHER
stahlfeile	stahl	feile	OTHER
steinfeile	stein	feile	OTHER
bandfink	band	fink	OTHER
bergfink	berg	fink	OTHER
bodenfink	boden	fink	OTHER
buchfink	buch	fink	OTHER
distelfink	distel	fink	OTHER
dreckfink	dreck	fink	DEROGATORY
galeriefink	galerie	fink	OTHER
goldfink	gold	fink	OTHER
grundfink	grund	fink	OTHER
kirschfink	kirsch	fink	OTHER
leberfink	leber	fink	OTHER
mistfink	mist	fink	DEROGATORY
papstfink	papst	fink	OTHER
prostafink	prosta	fink	OTHER
rosenfink	rose	fink	OTHER
schmutzfink	schmutz	fink	DEROGATORY
schneefink	schnee	fink	OTHER
steinfink	stein	fink	OTHER
strohfink	stroh	fink	OTHER
waldfink	wald	fink	OTHER
druckfarbenfleck	druckfarbe	fleck	OTHER
durchschlagfleck	durchschlag	fleck	OTHER
grafiti-fleck	grafiti	fleck	OTHER
grasfleck	gras	fleck	OTHER
harzfleck	harz	fleck	OTHER
kaffeefleck	kaffee	fleck	OTHER
klebstoff-fleck	klebstoff	fleck	OTHER
kugelschreiberfleck	kugelschreiber	fleck	OTHER
marmeladefleck	marmelade	fleck	OTHER
nierenfleck	niere	fleck	OTHER
pipi-fleck	pipi	fleck	OTHER
sahara-fleck	sahara	fleck	OTHER
schandfleck	schand	fleck	DEROGATORY
schweißfleck	schweiß	fleck	OTHER
speichelfleck	speichel	fleck	OTHER
tropfenfleck	tropfen	fleck	OTHER
uhu-fleck	uhu	fleck	OTHER
wachsfleck	wachs	fleck	OTHER
weinfleck	wein	fleck	OTHER
übertragungsfleck	übertragung	fleck	OTHER
beerenfleisch	beere	fleisch	OTHER
fickfleisch	ficken	fleisch	DEROGATORY
fischfleisch	fisch	fleisch	OTHER
fruchtfleisch	frucht	fleisch	OTHER
galgenfleisch	galgen	fleisch	OTHER
hackfleisch	hacken	fleisch	OTHER
hilton-fleisch	hilton	fleisch	OTHER
importfleisch	import	fleisch	OTHER
kartoffelfleisch	kartoffel	fleisch	OTHER
kebabfleisch	kebab	fleisch	OTHER
krokodil-fleisch	krokodil	fleisch	OTHER
meerschweinchenfleisch	meerschweinchen	fleisch	OTHER
pferdefleisch	pferd	fleisch	OTHER
putenfleisch	pute	fleisch	OTHER
qualitätsfleisch	qualität	fleisch	OTHER
rauchfleisch	rauch	fleisch	OTHER
rindergulaschfleisch	rindergulasch	fleisch	OTHER
schlangenfleisch	schlange	fleisch	OTHER
schweinefleisch	schwein	fleisch	OTHER
zucchinifleisch	zucchini	fleisch	OTHER
butterfliege	butter	fliege	OTHER
essigfliege	essig	fliege	OTHER
fallschirmfliege	fallschirm	fliege	OTHER
gemüsefliege	gemüse	fliege	OTHER
keramikfliege	keramik	fliege	OTHER
kompostfliege	kompost	fliege	OTHER
lakritzfliege	lakritz	fliege	OTHER
lauchfliege	lauch	fliege	OTHER
ochsenfliege	ochse	fliege	OTHER
papierfliege	papier	fliege	OTHER
plastikfliege	plastik	fliege	OTHER
rossfliege	ross	fliege	OTHER
salzfliege	salz	fliege	OTHER
sandfliege	sand	fliege	OTHER
scheißhausfliege	scheißhaus	fliege	DEROGATORY
skorpionsfliege	skorpion	fliege	OTHER
sommerfliege	sommer	fliege	OTHER
wettbewerbsfliege	wettbewerb	fliege	OTHER
yogafliege	yoga	fliege	OTHER
zwiebelfliege	zwiebel	fliege	OTHER
eckenflitzer	ecke	flitzer	OTHER
erdhöhlenflitzer	erdhöhle	flitzer	OTHER
flammenflitzer	flamme	flitzer	OTHER
flügelflitzer	flügel	flitzer	OTHER
frischluft-flitzer	frischluft	flitzer	OTHER
fußballflitzer	fußball	flitzer	OTHER
internet-flitzer	internet	flitzer	OTHER
kurvenflitzer	kurve	flitzer	OTHER
liegeflitzer	liege	flitzer	OTHER
linienflitzer	linie	flitzer	OTHER
orbitflitzer	orbit	flitzer	OTHER
pistenflitzer	piste	flitzer	OTHER
plastikflitzer	plastik	flitzer	OTHER
prestige-flitzer	prestige	flitzer	OTHER
ritzenflitzer	ritze	flitzer	DEROGATORY
schienenflitzer	schiene	flitzer	OTHER
spessart-flitzer	spessart	flitzer	OTHER
sport-flitzer	sport	flitzer	OTHER
straßenflitzer	straße	flitzer	OTHER
tunnelflitzer	tunnel	flitzer	OTHER
aasfresser	aas	fresser	OTHER
bakterienfresser	bakterium	fresser	OTHER
fischfresser	fisch	fresser	OTHER
fleischfresser	fleisch	fresser	OTHER
froschfresser	frosch	fresser	DEROGATORY
grasfresser	gras	fresser	OTHER
kolbenfresser	kolben	fresser	OTHER
krautfresser	kraut	fresser	DEROGATORY
käsefresser	käse	fresser	DEROGATORY
körnerfresser	korn	fresser	OTHER
madenfresser	made	fresser	OTHER
pillenfresser	pille	fresser	DEROGATORY
reisfresser	reis	fresser	DEROGATORY
schleimfresser	schleim	fresser	OTHER
sockenfresser	socke	fresser	OTHER
spaghettifresser	spaghetti	fresser	DEROGATORY
unkrautfresser	unkraut	fresser	OTHER
weichfutterfresser	weichfutter	fresser	OTHER
wurmfresser	wurm	fresser	OTHER
zahnfresser	zahn	fresser	OTHER
babyfuß	baby	fuß	OTHER
dachfuß	dach	fuß	OTHER
donnerfuß	donner	fuß	OTHER
friedensfuß	frieden	fuß	OTHER
gaisfuß	gais	fuß	OTHER
gansfuß	gans	fuß	OTHER
gletscherfuß	gletscher	fuß	OTHER
goldfuß	gold	fuß	OTHER
gummifuß	gummi	fuß	OTHER
hahnfuß	hahn	fuß	OTHER
hasenfuß	hase	fuß	DEROGATORY
kriegsfuß	krieg	fuß	OTHER
leiterfuß	leiter	fuß	OTHER
läufer-fuß	läufer	fuß	OTHER
moosfuß	moos	fuß	OTHER
porzellanfuß	porzellan	fuß	OTHER
scheckfuß	scheck	fuß	OTHER
schlammfuß	schlamm	fuß	OTHER
turnschuhfuß	turnschuh	fuß	OTHER
zinnfuß	zinn	fuß	OTHER
augenfänger	auge	fänger	OTHER
bauernfänger	bauer	fänger	DEROGATORY
bärenfänger	bär	fänger	OTHER
flohfänger	floh	fänger	OTHER
hirschfänger	hirsch	fänger	OTHER
hundefänger	hund	fänger	OTHER
katzenfänger	katze	fänger	OTHER
mörderfänger	mörder	fänger	OTHER
ozonfänger	ozon	fänger	OTHER
photonenfänger	photon	fänger	OTHER
rattenfänger	ratte	fänger	DEROGATORY
regenwurmfänger	regenwurm	fänger	OTHER
schlangenfänger	schlange	fänger	OTHER
sklavenfänger	sklave	fänger	OTHER
staubfänger	staub	fänger	OTHER
stimmenfänger	stimme	fänger	OTHER
tierfänger	tier	fänger	OTHER
traumfänger	traum	fänger	OTHER
tropfenfänger	tropfen	fänger	OTHER
wolkenfänger	wolke	fänger	OTHER
amateurganove	amateur	ganove	OTHER
angeber-ganove	angeber	ganove	DEROGATORY
autoganove	auto	ganove	OTHER
berufsganove	beruf	ganove	OTHER
bilderbuchganove	bilderbuch	ganove	OTHER
drogenganove	droge	ganove	OTHER
filmganove	film	ganove	OTHER
gelegenheitsganove	gelegenheit	ganove	OTHER
gentleman-ganove	gentleman	ganove	OTHER
gossenganove	gosse	ganove	DEROGATORY
internetganove	internet	ganove	DEROGATORY
klassiker-ganove	klassiker	ganove	OTHER
kleinstadtganove	kleinstadt	ganove	OTHER
mafiaganove	mafia	ganove	OTHER
nachwuchsganove	nachwuchs	ganove	OTHER
reiseganove	reise	ganove	OTHER
schmalspurganove	schmalspur	ganove	DEROGATORY
schwarzmarktganove	schwarzmarkt	ganove	OTHER
straßenganove	straße	ganove	DEROGATORY
vorstadtganove	vorstadt	ganove	OTHER
belüftungsgebläse	belüftung	gebläse	OTHER
druckluftgebläse	druckluft	gebläse	OTHER
ersatzgebläse	ersatz	gebläse	OTHER
frontscheibengebläse	frontscheibe	gebläse	OTHER
fruchtgebläse	frucht	gebläse	OTHER
heizungsgebläse	heizung	gebläse	OTHER
hochofengebläse	hochofen	gebläse	OTHER
holzgebläse	holz	gebläse	OTHER
kaltluftgebläse	kaltluft	gebläse	OTHER
kollektivgebläse	kollektiv	gebläse	OTHER
küchengebläse	küche	gebläse	OTHER
lüftungsgebläse	lüftung	gebläse	OTHER
mantelgebläse	mantel	gebläse	OTHER
orgelgebläse	orgel	gebläse	OTHER
propellergebläse	propeller	gebläse	OTHER
sandstrahlgebläse	sandstrahl	gebläse	OTHER
standgebläse	stand	gebläse	DEROGATORY
trocknungsgebläse	trocknung	gebläse	OTHER
warmluftgebläse	warmluft	gebläse	OTHER
zylindergebläse	zylinder	gebläse	OTHER
felsgeburt	fels	geburt	OTHER
gossengeburt	gosse	geburt	DEROGATORY
kaiserschnittgeburt	kaiserschnitt	geburt	OTHER
kindsgeburt	kind	geburt	OTHER
klongeburt	klonen	geburt	OTHER
krankenhausgeburt	krankenhaus	geburt	OTHER
kriegsgeburt	krieg	geburt	OTHER
massengeburt	masse	geburt	OTHER
mistgeburt	mist	geburt	DEROGATORY
plazentageburt	plazenta	geburt	OTHER
praxisgeburt	praxis	geburt	OTHER
schreckens-geburt	schrecken	geburt	OTHER
schöpfungsgeburt	schöpfung	geburt	OTHER
stallgeburt	stall	geburt	OTHER
sternengeburt	stern	geburt	OTHER
teufelsgeburt	teufel	geburt	DEROGATORY
traumgeburt	traum	geburt	OTHER
wassergeburt	wasser	geburt	OTHER
welpengeburt	welpe	geburt	OTHER
wundergeburt	wunder	geburt	OTHER
afrika-geschwader	afrika	geschwader	OTHER
ersatzgeschwader	ersatz	geschwader	OTHER
fallschirmjägergeschwader	fallschirmjäger	geschwader	OTHER
hubschraubergeschwader	hubschrauber	geschwader	OTHER
jagdbomber-geschwader	jagdbomber	geschwader	OTHER
kanonenbootgeschwader	kanonenboot	geschwader	OTHER
kanonengeschwader	kanone	geschwader	OTHER
karrieristengeschwader	karrierist	geschwader	DEROGATORY
krampfaderngeschwader	krampfader	geschwader	DEROGATORY
kunstfluggeschwader	kunstflug	geschwader	OTHER
luftschiffgeschwader	luftschiff	geschwader	OTHER
luftwaffen-geschwader	luftwaffe	geschwader	OTHER
mauersegler-geschwader	mauersegler	geschwader	OTHER
pilotengeschwader	pilot	geschwader	OTHER
putzgeschwader	putz	geschwader	OTHER
sowjetgeschwader	sowjet	geschwader	OTHER
südseegeschwader	südsee	geschwader	OTHER
terrorgeschwader	terror	geschwader	OTHER
versorgungsgeschwader	versorgung	geschwader	OTHER
überwachungsgeschwader	überwachung	geschwader	OTHER
adlergesicht	adler	gesicht	OTHER
bildschirmgesicht	bildschirm	gesicht	OTHER
covergesicht	cover	gesicht	OTHER
feiertagsgesicht	feiertag	gesicht	OTHER
fliegengesicht	fliege	gesicht	OTHER
kindesgesicht	kind	gesicht	OTHER
klongesicht	klonen	gesicht	OTHER
leinwandgesicht	leinwand	gesicht	OTHER
milchgesicht	milch	gesicht	DEROGATORY
miniaturgesicht	miniatur	gesicht	OTHER
model-gesicht	model	gesicht	OTHER
mädchengesicht	mädchen	gesicht	OTHER
mönchsgesicht	mönch	gesicht	OTHER
pickelgesicht	pickel	gesicht	DEROGATORY
pressegesicht	presse	gesicht	OTHER
sackgesicht	sack	gesicht	DEROGATORY
schaufensterpuppengesicht	schaufensterpuppe	gesicht	OTHER
schleiergesicht	schleier	gesicht	OTHER
spiegel-gesicht	spiegel	gesicht	OTHER
wollmützen-gesicht	wollmütze	gesicht	OTHER
antizipationsgestalt	antizipation	gestalt	OTHER
atomgestalt	atom	gestalt	OTHER
casanova-gestalt	casanova	gestalt	OTHER
clownsgestalt	clown	gestalt	OTHER
flügelgestalt	flügel	gestalt	OTHER
gruselgestalt	gruseln	gestalt	OTHER
jammergestalt	jammer	gestalt	DEROGATORY
knabengestalt	knabe	gestalt	OTHER
knochengestalt	knochen	gestalt	OTHER
leinwandgestalt	leinwand	gestalt	OTHER
liedgestalt	lied	gestalt	OTHER
ochsengestalt	ochse	gestalt	OTHER
puritanergestalt	puritaner	gestalt	OTHER
schaudergestalt	schauder	gestalt	OTHER
schreckensgestalt	schrecken	gestalt	OTHER
seebeckengestalt	seebecken	gestalt	OTHER
tiergestalt	tier	gestalt	OTHER
tragödiengestalt	tragödie	gestalt	OTHER
wesensgestalt	wesen	gestalt	OTHER
wurmgestalt	wurm	gestalt	OTHER
baumgreis	baum	greis	OTHER
dichtergreis	dichter	greis	OTHER
jubelgreis	jubel	greis	OTHER
katzengreis	katze	greis	OTHER
kindergreis	kind	greis	OTHER
kulturgreis	kultur	greis	OTHER
kunstgreis	kunst	greis	OTHER
lustgreis	lust	greis	DEROGATORY
meergreis	meer	greis	OTHER
mummelgreis	mummel	greis	DEROGATORY
priestergreis	priester	greis	OTHER
rentengreis	rente	greis	OTHER
sabbergreis	sabbern	greis	DEROGATORY
sängergreis	sänger	greis	OTHER
tapergreis	taper	greis	DEROGATORY
tattergreis	tatter	greis	DEROGATORY
weingreis	wein	greis	OTHER
wintergreis	winter	greis	OTHER
wundergreis	wunder	greis	OTHER
zittergreis	zitter	greis	OTHER
blumengriffel	blume	griffel	OTHER
diamantgriffel	diamant	griffel	OTHER
federgriffel	feder	griffel	OTHER
fälschergriffel	fälscher	griffel	OTHER
gichtgriffel	gicht	griffel	OTHER
giergriffel	gier	griffel	DEROGATORY
holzgriffel	holz	griffel	OTHER
kreidegriffel	kreide	griffel	OTHER
menschengriffel	mensch	griffel	OTHER
rohrgriffel	rohr	griffel	OTHER
samengriffel	same	griffel	OTHER
schiefergriffel	schiefer	griffel	OTHER
schreibergriffel	schreiber	griffel	OTHER
spaltgriffel	spalt	griffel	OTHER
steingriffel	stein	griffel	OTHER
strahlengriffel	strahl	griffel	OTHER
tuffsteingriffel	tuffstein	griffel	OTHER
wurstgriffel	wurst	griffel	OTHER
zaubergriffel	zauber	griffel	OTHER
zirkus-griffel	zirkus	griffel	OTHER
anteilhaber	anteil	haber	OTHER
armeebefehlshaber	armeebefehl	haber	OTHER
befehlhaber	befehl	haber	OTHER
befehlshaber	befehl	haber	OTHER
diensthaber	dienst	haber	OTHER
dokumentinhaber	dokumentin	haber	OTHER
fischhaber	fisch	haber	OTHER
gewalthaber	gewalt	haber	OTHER
goldhaber	gold	haber	OTHER
großmachthaber	großmacht	haber	OTHER
ideenhaber	idee	haber	OTHER
kriegshaber	krieg	haber	OTHER
machthaber	macht	haber	OTHER
militärmachthaber	militärmacht	haber	OTHER
oberbefehlshaber	oberbefehl	haber	OTHER
rechthaber	recht	haber	DEROGATORY
sinnhaber	sinn	haber	OTHER
teilhaber	teil	haber	OTHER
wildhaber	wild	haber	OTHER
windhaber	wind	haber	OTHER
angel-haken	angel	haken	OTHER
aufnahmehaken	aufnahme	haken	OTHER
betrachtungshaken	betrachtung	haken	OTHER
bootshaken	boot	haken	OTHER
champagnerhaken	champagner	haken	OTHER
dachhaken	dach	haken	OTHER
fensterhaken	fenster	haken	OTHER
fleischerhaken	fleischer	haken	OTHER
gardinenhaken	gardine	haken	OTHER
hungerhaken	hunger	haken	DEROGATORY
kreishaken	kreis	haken	OTHER
metallhaken	metall	haken	OTHER
monster-haken	monster	haken	OTHER
sandhaken	sand	haken	OTHER
schrifthaken	schrift	haken	OTHER
stahlhaken	stahl	haken	OTHER
standhaken	stand	haken	OTHER
verschlusshaken	verschluss	haken	OTHER
wandhaken	wand	haken	OTHER
wolfshaken	wolf	haken	OTHER
antilopenhals	antilope	hals	OTHER
ballonhals	ballon	hals	OTHER
blasenhals	blase	hals	OTHER
damenhals	dame	hals	OTHER
düsenhals	düse	hals	OTHER
elfenbeinhals	elfenbein	hals	OTHER
femurhals	femur	hals	OTHER
flaschenhals	flasche	hals	OTHER
gebärmutterhals	gebärmutter	hals	OTHER
geizhals	geizen	hals	DEROGATORY
instrumentenhals	instrument	hals	OTHER
krawattenhals	krawatte	hals	OTHER
lautenhals	lauten	hals	OTHER
mädchenhals	mädchen	hals	OTHER
patronenhals	patron	hals	OTHER
tubenhals	tube	hals	OTHER
wagenhals	wagen	hals	OTHER
wurzelhals	wurzel	hals	OTHER
zahnhals	zahn	hals	OTHER
ziegenhals	ziege	hals	OTHER
abstandhalter	abstand	halter	DEROGATORY
blutdruckhalter	blutdruck	halter	OTHER
buchhalter	buch	halter	OTHER
dekorations-halter	dekoration	halter	OTHER
fruchthalter	frucht	halter	OTHER
geschichtsbuchhalter	geschichtsbuch	halter	OTHER
hundehalter	hund	halter	OTHER
kampfhunde-halter	kampfhund	halter	OTHER
kükenhalter	küken	halter	OTHER
mopphalter	mop	halter	OTHER
motorenhalter	motor	halter	OTHER
nutzfahrzeughalter	nutzfahrzeug	halter	OTHER
präparathalter	präparat	halter	OTHER
reagenzglashalter	reagenzglas	halter	OTHER
rekordhalter	rekord	halter	OTHER
rennmaushalter	rennmaus	halter	OTHER
ski-halter	ski	halter	OTHER
spielbankhalter	spielbank	halter	OTHER
steigbügelhalter	steigbügel	halter	OTHER
zigarettenhalter	zigarette	halter	OTHER
bohrhammel	bohr	hammel	OTHER
festtagshammel	festtag	hammel	OTHER
fettschwanzhammel	fettschwanz	hammel	OTHER
fleischhammel	fleisch	hammel	OTHER
geizhammel	geizen	hammel	DEROGATORY
kirchenhammel	kirche	hammel	OTHER
leidhammel	leid	hammel	OTHER
opferhammel	opfer	hammel	OTHER
pfingsthammel	pfingst	hammel	OTHER
schafhammel	schaf	hammel	OTHER
schneehammel	schnee	hammel	OTHER
schottenhammel	schotten	hammel	OTHER
siegerhammel	sieger	hammel	OTHER
streithammel	streit	hammel	DEROGATORY
sündenhammel	sünde	hammel	OTHER
wolfshammel	wolf	hammel	OTHER
zeithammel	zeit	hammel	OTHER
zinkhammel	zink	hammel	OTHER
zuchthammel	zucht	hammel	OTHER
zwerghammel	zwerg	hammel	OTHER
angorahase	angora	hase	OTHER
angsthase	angst	hase	DEROGATORY
babyhase	baby	hase	OTHER
berghase	berg	hase	OTHER
duracell-hase	duracell	hase	OTHER
holzhase	holz	hase	OTHER
kuschelhase	kuscheln	hase	OTHER
lindt-hase	lindt	hase	OTHER
märzhase	märz	hase	OTHER
osterhase	oster	hase	OTHER
pampashase	pampa	hase	OTHER
plüschhase	plüsch	hase	OTHER
präriehase	prärie	hase	OTHER
riesenhase	riese	hase	OTHER
schlachthase	schlacht	hase	OTHER
schokoladenhase	schokolade	hase	OTHER
stallhase	stall	hase	OTHER
stoffhase	stoff	hase	OTHER
waldhase	wald	hase	OTHER
zuckerhase	zucker	hase	OTHER
crossover-held	crossover	held	OTHER
kinoheld	kino	held	OTHER
künstlerheld	künstler	held	OTHER
maulheld	maul	held	DEROGATORY
pantoffelheld	pantoffel	held	DEROGATORY
psychiaterheld	psychiater	held	OTHER
rallye-held	rallye	held	OTHER
rasenheld	rasen	held	OTHER
rennsport-held	rennsport	held	OTHER
ringerheld	ringer	held	OTHER
schottenheld	schotten	held	OTHER
sintflutheld	sintflut	held	OTHER
spielerheld	spieler	held	OTHER
story-held	story	held	OTHER
szene-held	szene	held	OTHER
terrorheld	terror	held	OTHER
tragödien-held	tragödie	held	OTHER
trojanerheld	trojaner	held	OTHER
widerstands-held	widerstand	held	OTHER
zehnkampf-held	zehnkampf	held	OTHER
araberhengst	araber	hengst	OTHER
ausnahmehengst	ausnahme	hengst	OTHER
bürohengst	büro	hengst	DEROGATORY
dressurhengst	dressur	hengst	OTHER
elitehengst	elite	hengst	OTHER
eselhengst	esel	hengst	OTHER
friesenhengst	fries	hengst	OTHER
fuchshengst	fuchs	hengst	OTHER
kaltbluthengst	kaltblut	hengst	OTHER
paragraphenhengst	paragraph	hengst	DEROGATORY
partyhengst	party	hengst	OTHER
ponyhengst	pony	hengst	OTHER
prämienhengst	prämie	hengst	OTHER
rapphengst	rapp	hengst	OTHER
schimmelhengst	schimmel	hengst	OTHER
schreibtischhengst	schreibtisch	hengst	DEROGATORY
siegerhengst	sieger	hengst	OTHER
stempelhengst	stempel	hengst	OTHER
vollbluthengst	vollblut	hengst	OTHER
zuchthengst	zucht	hengst	OTHER
albino-henne	albino	henne	OTHER
ammen-henne	amme	henne	OTHER
auerhenne	auer	henne	OTHER
bruthenne	brut	henne	OTHER
fenster-henne	fenster	henne	OTHER
geflügelhenne	geflügel	henne	OTHER
herbsthenne	herbst	henne	OTHER
himmelshenne	himmel	henne	OTHER
hochleistungshenne	hochleistung	henne	OTHER
krampfhenne	krampf	henne	DEROGATORY
käfighenne	käfig	henne	OTHER
lachshenne	lachs	henne	OTHER
mischlingshenne	mischling	henne	OTHER
möwenhenne	möwe	henne	OTHER
osterhenne	oster	henne	OTHER
rassehenne	rasse	henne	OTHER
schopfhenne	schopf	henne	OTHER
streithenne	streit	henne	DEROGATORY
windhenne	wind	henne	OTHER
zwergenhenne	zwerg	henne	OTHER
armenhäusler	arm	häusler	OTHER
auenhäusler	aue	häusler	OTHER
brauhäusler	brauen	häusler	OTHER
forstenhäusler	forst	häusler	OTHER
gartenhäusler	garten	häusler	OTHER
gewandhäusler	gewand	häusler	OTHER
irrenhäusler	irre	häusler	DEROGATORY
katzenhäusler	katze	häusler	OTHER
rauchhäusler	rauch	häusler	OTHER
reihenhäusler	reihe	häusler	OTHER
schlafhäusler	schlaf	häusler	OTHER
schneckenhäusler	schnecke	häusler	OTHER
spinnhäusler	spinnen	häusler	OTHER
steinhäusler	stein	häusler	OTHER
tanzhäusler	tanz	häusler	OTHER
taubenhäusler	taube	häusler	OTHER
tropfhäusler	tropf	häusler	OTHER
waisenhäusler	waise	häusler	OTHER
waldhäusler	wald	häusler	OTHER
zuchthäusler	zucht	häusler	DEROGATORY
bachhörer	bach	hörer	OTHER
chartshörer	chart	hörer	DEROGATORY
durchschnittshörer	durchschnitt	hörer	OTHER
emotionshörer	emotion	hörer	OTHER
freizeithörer	freizeit	hörer	OTHER
gasthörer	gast	hörer	OTHER
glashörer	glas	hörer	OTHER
handy-hörer	handy	hörer	OTHER
jazzhörer	jazz	hörer	OTHER
knopfhörer	knopf	hörer	OTHER
kopfhörer	kopf	hörer	OTHER
kurzwellenhörer	kurzwelle	hörer	OTHER
lokalradio-hörer	lokalradio	hörer	OTHER
mobiltelefonhörer	mobiltelefon	hörer	OTHER
rockmusikhörer	rockmusik	hörer	OTHER
schubert-hörer	schubert	hörer	OTHER
wdr-hörer	wdr	hörer	OTHER
zauberhörer	zauber	hörer	OTHER
zeithörer	zeit	hörer	OTHER
zeitungshörer	zeitung	hörer	OTHER
ameisenigel	ameise	igel	OTHER
borstenigel	borste	igel	OTHER
gel-igel	gel	igel	OTHER
giraffenigel	giraffe	igel	OTHER
hasenigel	hase	igel	OTHER
herzigel	herz	igel	OTHER
kresseigel	kresse	igel	OTHER
käseigel	käse	igel	OTHER
plüsch-igel	plüsch	igel	OTHER
saugigel	saug	igel	OTHER
schnabeligel	schnabel	igel	OTHER
schnee-igel	schnee	igel	OTHER
schweinigel	schwein	igel	DEROGATORY
seifenigel	seife	igel	OTHER
steppenigel	steppe	igel	OTHER
streichholzigel	streichholz	igel	OTHER
waldigel	wald	igel	OTHER
wochenigel	woche	igel	OTHER
zwergigel	zwerg	igel	OTHER
überwinterungsigel	überwinterung	igel	OTHER
aschenjunge	asche	junge	OTHER
besenjunge	besen	junge	OTHER
braunbärenjunge	braunbär	junge	OTHER
bürojunge	büro	junge	OTHER
entenjunge	ente	junge	OTHER
ersatzjunge	ersatz	junge	OTHER
hüttenjunge	hütte	junge	OTHER
kleinstadt-junge	kleinstadt	junge	OTHER
konditorjunge	konditor	junge	OTHER
latinojunge	latino	junge	OTHER
lausejunge	lause	junge	DEROGATORY
löwenjunge	löwe	junge	OTHER
motor-junge	motor	junge	OTHER
nomadenjunge	nomade	junge	OTHER
ringeltaubenjunge	ringeltaube	junge	OTHER
schiffsjunge	schiff	junge	OTHER
sklavenjunge	sklave	junge	OTHER
steinzeitjunge	steinzeit	junge	OTHER
waisenjunge	waise	junge	OTHER
waldjunge	wald	junge	OTHER
auflagen-jäger	auflage	jäger	OTHER
delphin-jäger	delphin	jäger	OTHER
favoriten-jäger	favorit	jäger	OTHER
geißbockjäger	geißbock	jäger	OTHER
gezeitenjäger	gezeit	jäger	OTHER
harpunenjäger	harpune	jäger	OTHER
hirschjäger	hirsch	jäger	OTHER
kanonenjäger	kanone	jäger	OTHER
klangjäger	klang	jäger	OTHER
kostenjäger	kosten	jäger	OTHER
milbenjäger	milbe	jäger	OTHER
pistenjäger	piste	jäger	OTHER
planetoidenjäger	planetoid	jäger	OTHER
schürzenjäger	schürze	jäger	DEROGATORY
spielspaßjäger	spielspaß	jäger	OTHER
stasi-jäger	stasi	jäger	OTHER
u-boot-jäger	uboot	jäger	OTHER
vampirjäger	vampir	jäger	OTHER
volksjäger	volk	jäger	OTHER
wildschweinjäger	wildschwein	jäger	OTHER
alpenkalb	alp	kalb	OTHER
bullenkalb	bulle	kalb	OTHER
elch-kalb	elch	kalb	OTHER
giraffenkalb	giraffe	kalb	OTHER
gnu-kalb	gnu	kalb	OTHER
grauwalkalb	grauwal	kalb	OTHER
importkalb	import	kalb	OTHER
kamelkalb	kamel	kalb	OTHER
kreuzungskalb	kreuzung	kalb	OTHER
meerkalb	meer	kalb	OTHER
milchkalb	milch	kalb	OTHER
mondkalb	mond	kalb	DEROGATORY
moschusochsenkalb	moschusochse	kalb	OTHER
qualitätskalb	qualität	kalb	OTHER
rinderkalb	rind	kalb	OTHER
rothirschkalb	rothirsch	kalb	OTHER
stierenkalb	stier	kalb	OTHER
tierkalb	tier	kalb	OTHER
versuchskalb	versuch	kalb	OTHER
weidekalb	weide	kalb	OTHER
abendmahlkanne	abendmahl	kanne	OTHER
aluminiumkanne	aluminium	kanne	OTHER
bierkanne	bier	kanne	OTHER
blattkanne	blatt	kanne	OTHER
brandkanne	brand	kanne	DEROGATORY
breitensportkanne	breitensport	kanne	OTHER
bronzekanne	bronze	kanne	OTHER
druckkanne	druck	kanne	OTHER
filterkanne	filter	kanne	OTHER
glaskanne	glas	kanne	OTHER
glühwein-kanne	glühwein	kanne	OTHER
jugendstil-kanne	jugendstil	kanne	OTHER
kotzkanne	kotzen	kanne	DEROGATORY
metallkanne	metall	kanne	OTHER
saftkanne	saft	kanne	OTHER
suppenkanne	suppe	kanne	OTHER
tagungskanne	tagung	kanne	OTHER
termoskanne	termos	kanne	OTHER
vogelkanne	vogel	kanne	OTHER
wasserkanne	wasser	kanne	OTHER
armee-kanone	armee	kanone	OTHER
bier-kanone	bier	kanone	OTHER
bonbonkanone	bonbon	kanone	OTHER
bootskanone	boot	kanone	OTHER
erbsensuppenkanone	erbsensuppe	kanone	OTHER
erfolgskanone	erfolg	kanone	OTHER
frontkanone	front	kanone	OTHER
furzkanone	furz	kanone	DEROGATORY
gausskanone	gauß	kanone	OTHER
harpunen-kanone	harpune	kanone	OTHER
jagdkanone	jagd	kanone	OTHER
lederkanone	leder	kanone	OTHER
materialkanone	material	kanone	OTHER
mittagskanone	mittag	kanone	OTHER
netzkanone	netz	kanone	OTHER
propellerkanone	propeller	kanone	OTHER
schrotkanone	schrot	kanone	OTHER
sonarkanone	sonar	kanone	OTHER
unterhaltungskanone	unterhaltung	kanone	OTHER
wasserkanone	wasser	kanone	OTHER
albino-kellner	albino	kellner	OTHER
bistrokellner	bistro	kellner	OTHER
chefkellner	chef	kellner	OTHER
empfangskellner	empfang	kellner	OTHER
etagenkellner	etage	kellner	OTHER
frühstückskellner	frühstück	kellner	OTHER
getränkekellner	getränk	kellner	OTHER
kölsch-kellner	kölsch	kellner	OTHER
rathauskellner	rathaus	kellner	OTHER
restaurantkellner	restaurant	kellner	OTHER
ritz-kellner	ritz	kellner	OTHER
rollschuhkellner	rollschuh	kellner	OTHER
schiffskellner	schiff	kellner	OTHER
speisewagenkellner	speisewagen	kellner	OTHER
stepptanz-kellner	stepptanz	kellner	OTHER
surfer-kellner	surfer	kellner	OTHER
urinkellner	urin	kellner	DEROGATORY
wagenkellner	wagen	kellner	OTHER
wein-kellner	wein	kellner	OTHER
zimmerkellner	zimmer	kellner	OTHER
bayern-killer	bayern	killer	OTHER
berufskiller	beruf	killer	OTHER
bienenkiller	biene	killer	OTHER
cola-killer	cola	killer	OTHER
eurokiller	euro	killer	OTHER
familienkiller	familie	killer	OTHER
figur-killer	figur	killer	OTHER
fluchkiller	fluch	killer	OTHER
identitätskiller	identität	killer	OTHER
lungenkiller	lunge	killer	OTHER
natur-killer	natur	killer	OTHER
partykiller	party	killer	DEROGATORY
pflanzenkiller	pflanze	killer	OTHER
produktivitätskiller	produktivität	killer	OTHER
ritualkiller	ritual	killer	OTHER
serverkiller	server	killer	OTHER
spam-killer	spam	killer	OTHER
umweltkiller	umwelt	killer	OTHER
zahnstein-killer	zahnstein	killer	OTHER
zebra-killer	zebra	killer	OTHER
adoptivkind	adoptiv	kind	OTHER
christkind	christ	kind	OTHER
enkelkind	enkel	kind	OTHER
geburtstagskind	geburtstag	kind	OTHER
geschwisterkind	geschwister	kind	OTHER
grundschulkind	grundschul	kind	OTHER
heimkind	heim	kind	OTHER
jesuskind	jesus	kind	OTHER
katzenkind	katze	kind	OTHER
kindergartenkind	kindergarten	kind	OTHER
menschenkind	mensch	kind	OTHER
patenkind	pate	kind	OTHER
pflegekind	pflege	kind	OTHER
schulkind	schulen	kind	OTHER
sorgenkind	sorge	kind	OTHER
spielkind	spiel	kind	DEROGATORY
straßenkind	straße	kind	DEROGATORY
vorschulkind	vorschul	kind	OTHER
waisenkind	waise	kind	OTHER
wunderkind	wunder	kind	OTHER
bandenklatscher	bande	klatscher	OTHER
bauchklatscher	bauch	klatscher	OTHER
beifallklatscher	beifall	klatscher	DEROGATORY
dauerklatscher	dauer	klatscher	DEROGATORY
fersenklatscher	ferse	klatscher	OTHER
fliegenklatscher	fliege	klatscher	OTHER
handklatscher	hand	klatscher	OTHER
händeklatscher	hand	klatscher	OTHER
landungsklatscher	landung	klatscher	DEROGATORY
nackenklatscher	nacken	klatscher	OTHER
pappklatscher	papp	klatscher	OTHER
pfotenklatscher	pfote	klatscher	OTHER
popoklatscher	popo	klatscher	OTHER
rückenklatscher	rücken	klatscher	OTHER
schenkelklatscher	schenkel	klatscher	OTHER
spiegelklatscher	spiegel	klatscher	OTHER
stirnklatscher	stirn	klatscher	OTHER
tortenklatscher	torte	klatscher	OTHER
wandklatscher	wand	klatscher	OTHER
zipfelklatscher	zipfel	klatscher	DEROGATORY
abwehrklopfer	abwehr	klopfer	OTHER
buschklopfer	busch	klopfer	OTHER
dreschflegelklopfer	dreschflegel	klopfer	OTHER
energie-klopfer	energie	klopfer	OTHER
fensterklopfer	fenster	klopfer	OTHER
fingerklopfer	finger	klopfer	OTHER
mauerklopfer	mauer	klopfer	OTHER
messingklopfer	messing	klopfer	OTHER
metallklopfer	metall	klopfer	OTHER
oberschenkelklopfer	oberschenkel	klopfer	OTHER
puddingklopfer	pudding	klopfer	DEROGATORY
schenkelklopfer	schenkel	klopfer	OTHER
schnitzelklopfer	schnitzel	klopfer	OTHER
schulterklopfer	schulter	klopfer	OTHER
schädelklopfer	schädel	klopfer	OTHER
sprücheklopfer	spruch	klopfer	DEROGATORY
steinklopfer	stein	klopfer	OTHER
taktklopfer	takt	klopfer	OTHER
teppichklopfer	teppich	klopfer	OTHER
tischklopfer	tisch	klopfer	OTHER
aprikosenkloß	aprikose	kloß	OTHER
bohnenkloß	bohne	kloß	OTHER
bratkloß	brat	kloß	OTHER
buchweizenkloß	buchweizen	kloß	OTHER
dinkelkloß	dinkel	kloß	OTHER
fettkloß	fett	kloß	DEROGATORY
fischkloß	fisch	kloß	OTHER
fleischkloß	fleisch	kloß	OTHER
grünkernkloß	grünkern	kloß	OTHER
hechtkloß	hecht	kloß	OTHER
kaiserkloß	kaiser	kloß	OTHER
kartoffelkloß	kartoffel	kloß	OTHER
maismehlkloß	maismehl	kloß	OTHER
markkloß	mark	kloß	OTHER
mehlkloß	mehl	kloß	OTHER
mohnkloß	mohn	kloß	OTHER
planktonkloß	plankton	kloß	OTHER
semmelkloß	semmel	kloß	OTHER
teigkloß	teig	kloß	OTHER
trauerkloß	trauer	kloß	DEROGATORY
antennenknicker	antenne	knicker	DEROGATORY
briefknicker	brief	knicker	OTHER
erdbebenknicker	erdbeben	knicker	OTHER
familienknicker	familie	knicker	OTHER
freizeit-knicker	freizeit	knicker	OTHER
fähnchenknicker	fähnchen	knicker	DEROGATORY
glasknicker	glas	knicker	OTHER
heringsknicker	hering	knicker	OTHER
jugendknicker	jugend	knicker	OTHER
karriereknicker	karriere	knicker	OTHER
kennzeichenknicker	kennzeichen	knicker	DEROGATORY
kerzenknicker	kerze	knicker	DEROGATORY
kissenknicker	kissen	knicker	OTHER
leuchtstabknicker	leuchtstab	knicker	OTHER
metallknicker	metall	knicker	OTHER
pillenknicker	pille	knicker	OTHER
sonnenknicker	sonne	knicker	OTHER
sportknicker	sport	knicker	OTHER
tulpenknicker	tulpe	knicker	DEROGATORY
witzknicker	witz	knicker	OTHER
beinknochen	bein	knochen	OTHER
fleischknochen	fleisch	knochen	OTHER
geizknochen	geizen	knochen	DEROGATORY
gesichtsknochen	gesicht	knochen	OTHER
gesäßknochen	gesäß	knochen	OTHER
heiligen-knochen	heilige	knochen	OTHER
hüftbeinknochen	hüftbein	knochen	OTHER
keulenknochen	keule	knochen	OTHER
kormoranknochen	kormoran	knochen	OTHER
kotelettknochen	kotelett	knochen	OTHER
lammknochen	lamm	knochen	OTHER
leichenknochen	leiche	knochen	OTHER
nasenbeinknochen	nasenbein	knochen	OTHER
oberkeulenknochen	oberkeule	knochen	OTHER
ringfingerknochen	ringfinger	knochen	OTHER
schafsknochen	schaf	knochen	OTHER
schläfenknochen	schläfe	knochen	OTHER
sitzbeinknochen	sitzbein	knochen	OTHER
unterarmknochen	unterarm	knochen	OTHER
vogelknochen	vogel	knochen	OTHER
amateurkoch	amateur	koch	OTHER
berufskoch	beruf	koch	OTHER
büro-koch	büro	koch	OTHER
crack-koch	crack	koch	OTHER
diätkoch	diät	koch	OTHER
dosenkoch	dose	koch	DEROGATORY
drogenkoch	droge	koch	OTHER
feldkoch	feld	koch	OTHER
hamburger-koch	hamburger	koch	OTHER
hobbykoch	hobby	koch	OTHER
hochzeitskoch	hochzeit	koch	OTHER
kantinenkoch	kantine	koch	OTHER
militärkoch	militär	koch	OTHER
promikoch	promi	koch	OTHER
reisekoch	reise	koch	OTHER
schülerkoch	schüler	koch	OTHER
show-koch	show	koch	OTHER
suppenkoch	suppe	koch	OTHER
vorstandskoch	vorstand	koch	OTHER
wehrmachtskoch	wehrmacht	koch	OTHER
bündchenkragen	bündchen	kragen	OTHER
ersatzkragen	ersatz	kragen	OTHER
fuchskragen	fuchs	kragen	OTHER
geizkragen	geizen	kragen	DEROGATORY
goldkragen	gold	kragen	OTHER
gummikragen	gummi	kragen	OTHER
hemdenkragen	hemd	kragen	OTHER
hengstkragen	hengst	kragen	OTHER
killerkragen	killer	kragen	OTHER
kostümkragen	kostüm	kragen	OTHER
kunststoffkragen	kunststoff	kragen	OTHER
leistenkragen	leiste	kragen	OTHER
nadel-kragen	nadel	kragen	OTHER
predigerkragen	prediger	kragen	OTHER
priesterkragen	priester	kragen	OTHER
schaumkragen	schaum	kragen	OTHER
sicherheitskragen	sicherheit	kragen	OTHER
stammkragen	stamm	kragen	OTHER
wasserfallkragen	wasserfall	kragen	OTHER
wärmekragen	wärme	kragen	OTHER
autobahnkriecher	autobahn	kriecher	DEROGATORY
bodenkriecher	boden	kriecher	OTHER
bush-kriecher	bush	kriecher	DEROGATORY
feldkriecher	feld	kriecher	OTHER
flachlandkriecher	flachland	kriecher	DEROGATORY
höhlenkriecher	höhle	kriecher	OTHER
illuminati-kriecher	illuminati	kriecher	DEROGATORY
kluftkriecher	kluft	kriecher	OTHER
lochkriecher	loch	kriecher	OTHER
monarchenkriecher	monarch	kriecher	DEROGATORY
nachtkriecher	nacht	kriecher	OTHER
ohrenkriecher	ohr	kriecher	OTHER
parteikriecher	partei	kriecher	DEROGATORY
sandkriecher	sand	kriecher	OTHER
schleimkriecher	schleim	kriecher	OTHER
schlickkriecher	schlick	kriecher	OTHER
steinkriecher	stein	kriecher	OTHER
trompetenkriecher	trompete	kriecher	OTHER
wasserkriecher	wasser	kriecher	OTHER
wüstenkriecher	wüst	kriecher	OTHER
arzneimittelkrämer	arzneimittel	krämer	OTHER
dorfkrämer	dorf	krämer	OTHER
eisenkrämer	eisen	krämer	OTHER
geheimniskrämer	geheimnis	krämer	OTHER
gemüsekrämer	gemüse	krämer	OTHER
gerüchtekrämer	gerücht	krämer	OTHER
gewürzkrämer	gewürz	krämer	OTHER
glaskrämer	glas	krämer	OTHER
handelskrämer	handel	krämer	OTHER
karikaturistenkrämer	karikaturist	krämer	OTHER
kleinigkeitskrämer	kleinigkeit	krämer	OTHER
krautkrämer	kraut	krämer	OTHER
landkrämer	land	krämer	OTHER
marktkrämer	markt	krämer	OTHER
neuigkeitskrämer	neuigkeit	krämer	OTHER
schriftenkrämer	schrift	krämer	OTHER
todeskrämer	tod	krämer	OTHER
umstandskrämer	umstand	krämer	DEROGATORY
waffenkrämer	waffe	krämer	OTHER
zivilisationskrämer	zivilisation	krämer	OTHER
abschlussball-könig	abschlussball	könig	OTHER
bergkönig	berg	könig	OTHER
eingeborenen-könig	eingeborene	könig	OTHER
forumkönig	forum	könig	OTHER
frankenkönig	franke	könig	OTHER
gondel-könig	gondel	könig	OTHER
hunnenkönig	hunne	könig	OTHER
imbisskönig	imbiss	könig	OTHER
jahreskönig	jahr	könig	OTHER
kaffeekönig	kaffee	könig	OTHER
kommunikations-könig	kommunikation	könig	OTHER
lichtkönig	licht	könig	OTHER
ostfrankenkönig	ostfranken	könig	OTHER
puppenkönig	puppe	könig	OTHER
rabenkönig	rabe	könig	OTHER
rollenspielkönig	rollenspiel	könig	OTHER
schwalbenkönig	schwalbe	könig	DEROGATORY
sprinterkönig	sprinter	könig	OTHER
ungarnkönig	ungarn	könig	OTHER
zirkuskönig	zirkus	könig	OTHER
ausdauer-lutscher	ausdauer	lutscher	OTHER
brauselutscher	brause	lutscher	OTHER
colalutscher	cola	lutscher	OTHER
dauerlutscher	dauer	lutscher	OTHER
daumenlutscher	daumen	lutscher	OTHER
dropslutscher	drops	lutscher	OTHER
feigenlutscher	feige	lutscher	DEROGATORY
hodenlutscher	hoden	lutscher	DEROGATORY
jahrmarktslutscher	jahrmarkt	lutscher	OTHER
karamellutscher	karamel	lutscher	OTHER
lakritzlutscher	lakritz	lutscher	OTHER
milchlutscher	milch	lutscher	OTHER
osterhasenlutscher	osterhase	lutscher	OTHER
papstlutscher	papst	lutscher	OTHER
schuhlutscher	schuh	lutscher	DEROGATORY
schwanzlutscher	schwanz	lutscher	DEROGATORY
seifenlutscher	seife	lutscher	DEROGATORY
spaghettilutscher	spaghetti	lutscher	DEROGATORY
zitronenlutscher	zitrone	lutscher	OTHER
zuckerlutscher	zucker	lutscher	OTHER
actionfilm-macher	actionfilm	macher	OTHER
airbusmacher	airbus	macher	OTHER
appetitmacher	appetit	macher	OTHER
augenmacher	auge	macher	OTHER
büchsenmacher	büchse	macher	OTHER
cola-macher	cola	macher	OTHER
comic-macher	comic	macher	OTHER
dvd-macher	dvd	macher	OTHER
entscheidungsmacher	entscheidung	macher	OTHER
festival-macher	festival	macher	OTHER
filmemacher	film	macher	OTHER
gastromacher	gastro	macher	OTHER
gesetzesmacher	gesetz	macher	OTHER
lexikonmacher	lexikon	macher	OTHER
liedermacher	lied	macher	OTHER
mut-macher	mut	macher	OTHER
papiermacher	papier	macher	OTHER
pisa-macher	pisa	macher	OTHER
spaßmacher	spaß	macher	OTHER
sprüchemacher	spruch	macher	DEROGATORY
bergmade	berg	made	OTHER
bienenmade	biene	made	OTHER
drohnenmade	drohn	made	OTHER
fliegenmade	fliege	made	OTHER
fruchtmade	frucht	made	OTHER
grasnomade	grasno	made	OTHER
holzmade	holz	made	OTHER
horn-made	horn	made	OTHER
insektenmade	insekt	made	OTHER
leichenmade	leiche	made	OTHER
mistmade	mist	made	DEROGATORY
mottenmade	motte	made	OTHER
müllmade	müll	made	OTHER
regenmade	regen	made	OTHER
rock-made	rock	made	OTHER
rohrmade	rohr	made	OTHER
sandmade	sand	made	OTHER
wachsmade	wachs	made	OTHER
wundmade	wund	made	OTHER
wurmmade	wurm	made	OTHER
amateurmaler	amateur	maler	OTHER
baarmaler	baar	maler	OTHER
barockmaler	barock	maler	OTHER
comicmaler	comic	maler	OTHER
durchschnittsmaler	durchschnitt	maler	OTHER
eiermaler	ei	maler	DEROGATORY
film-maler	film	maler	OTHER
freizeit-maler	freizeit	maler	OTHER
gerstenmaler	gerste	maler	OTHER
glasmaler	glas	maler	OTHER
heiligenbildmaler	heiligenbild	maler	OTHER
herzchenmaler	herzchen	maler	DEROGATORY
historien-maler	historie	maler	OTHER
hoftheatermaler	hoftheater	maler	OTHER
hollywood-maler	hollywood	maler	OTHER
ikonen-maler	ikone	maler	OTHER
nachwuchs-maler	nachwuchs	maler	OTHER
schiffsmaler	schiff	maler	OTHER
schollenmaler	scholle	maler	OTHER
stubenmaler	stube	maler	OTHER
ehrenmann	ehre	mann	OTHER
ekelmann	ekel	mann	DEROGATORY
geschäftsmann	geschäft	mann	OTHER
gewerbemann	gewerbe	mann	OTHER
gottesmann	gott	mann	OTHER
hausmann	haus	mann	OTHER
holzmann	holz	mann	OTHER
knüppelmann	knüppel	mann	OTHER
laden-mann	laden	mann	OTHER
landsmann	land	mann	OTHER
medizinmann	medizin	mann	OTHER
milchmann	milch	mann	OTHER
märchenmann	märchen	mann	OTHER
partei-mann	partei	mann	OTHER
schlussmann	schluss	mann	OTHER
schlüsselmann	schlüssel	mann	OTHER
schneemann	schnee	mann	OTHER
traummann	traum	mann	OTHER
wahlmann	wahl	mann	OTHER
wassermann	wasser	mann	OTHER
allergiker-matratze	allergiker	matratze	OTHER
babymatratze	baby	matratze	OTHER
betonmatratze	beton	matratze	OTHER
campingmatratze	camping	matratze	OTHER
dorfmatratze	dorf	matratze	DEROGATORY
einstreumatratze	einstreu	matratze	OTHER
federmatratze	feder	matratze	OTHER
gesundheitsmatratze	gesundheit	matratze	OTHER
latexmatratze	latex	matratze	OTHER
ledermatratze	leder	matratze	OTHER
magnet-matratze	magnet	matratze	OTHER
naturmatratze	natur	matratze	OTHER
pflanzen-matratze	pflanze	matratze	OTHER
probematratze	probe	matratze	OTHER
reklamematratze	reklame	matratze	OTHER
strandmatratze	strand	matratze	OTHER
traktionsmatratze	traktion	matratze	OTHER
vereinsmatratze	verein	matratze	DEROGATORY
wasserbettmatratze	wasserbett	matratze	OTHER
übernachtungsmatratze	übernachtung	matratze	OTHER
affenmaul	affe	maul	OTHER
drachenmaul	drache	maul	OTHER
ersatzmaul	ersatz	maul	OTHER
fischmaul	fisch	maul	OTHER
froschmaul	frosch	maul	OTHER
hundemaul	hund	maul	OTHER
karpfenmaul	karpfen	maul	OTHER
katzenmaul	katze	maul	OTHER
krokodilmaul	krokodil	maul	OTHER
krötenmaul	kröte	maul	OTHER
kussmaul	kuss	maul	OTHER
lügenmaul	lüge	maul	DEROGATORY
ochsenmaul	ochse	maul	OTHER
pferdemaul	pferd	maul	OTHER
raubtiermaul	raubtier	maul	OTHER
schlangenmaul	schlange	maul	OTHER
schweinsmaul	schwein	maul	OTHER
tiermaul	tier	maul	OTHER
ungeheuermaul	ungeheuer	maul	OTHER
zuckermaul	zucker	maul	OTHER
alpenmolch	alp	molch	OTHER
bergmolch	berg	molch	OTHER
fadenmolch	faden	molch	OTHER
gartenmolch	garten	molch	OTHER
kammmolch	kamm	molch	OTHER
kanalmolch	kanal	molch	OTHER
karpatenmolch	karpaten	molch	OTHER
kohlenmolch	kohle	molch	OTHER
krokodilmolch	krokodil	molch	OTHER
körnchenmolch	körnchen	molch	OTHER
ledermolch	leder	molch	OTHER
lustmolch	lust	molch	DEROGATORY
marmormolch	marmor	molch	OTHER
panzermolch	panzer	molch	OTHER
regenmolch	regen	molch	OTHER
schwefelmolch	schwefel	molch	OTHER
streifenmolch	streifen	molch	OTHER
teichmolch	teich	molch	OTHER
versuchsmolch	versuch	molch	OTHER
wassermolch	wasser	molch	OTHER
dreirad-moped	dreirad	moped	OTHER
fichtenmoped	fichte	moped	OTHER
flakmoped	flak	moped	OTHER
gebrauchtmoped	gebraucht	moped	OTHER
geländemoped	gelände	moped	OTHER
gesichtsmoped	gesicht	moped	DEROGATORY
holzmoped	holz	moped	OTHER
kult-moped	kult	moped	OTHER
lastenmoped	last	moped	OTHER
nato-moped	nato	moped	OTHER
peugeot-moped	peugeot	moped	OTHER
schlammmoped	schlamm	moped	OTHER
schrottplatzmoped	schrottplatz	moped	OTHER
steinzeitmoped	steinzeit	moped	OTHER
traummoped	traum	moped	OTHER
volksmoped	volk	moped	OTHER
wassermoped	wasser	moped	OTHER
wasserstoff-moped	wasserstoff	moped	OTHER
weltraum-moped	weltraum	moped	OTHER
zeitmoped	zeit	moped	OTHER
adler-mutter	adler	mutter	OTHER
amselmutter	amsel	mutter	OTHER
bärenmutter	bär	mutter	OTHER
gewindemutter	gewinde	mutter	OTHER
greif-mutter	greif	mutter	OTHER
katzenmutter	katze	mutter	OTHER
krokodil-mutter	krokodil	mutter	OTHER
neandertalermutter	neandertaler	mutter	OTHER
ninja-mutter	ninja	mutter	OTHER
pflegemutter	pflege	mutter	OTHER
polizeimutter	polizei	mutter	OTHER
primatenmutter	primat	mutter	OTHER
rabenmutter	rabe	mutter	DEROGATORY
rattenmutter	ratte	mutter	OTHER
risikomutter	risiko	mutter	OTHER
seehundmutter	seehund	mutter	OTHER
tagesmutter	tag	mutter	OTHER
teufelsmutter	teufel	mutter	OTHER
walkürenmutter	walküre	mutter	OTHER
zahlmutter	zahl	mutter	DEROGATORY
affenmädchen	affe	mädchen	OTHER
borgmädchen	borg	mädchen	OTHER
elfenmädchen	elfe	mädchen	OTHER
gardemädchen	garde	mädchen	OTHER
gartenmädchen	garten	mädchen	OTHER
hawaii-mädchen	hawaii	mädchen	OTHER
hirtenmädchen	hirte	mädchen	OTHER
hütermädchen	hüter	mädchen	OTHER
internatsmädchen	internat	mädchen	OTHER
kammermädchen	kammer	mädchen	OTHER
känguru-mädchen	känguruh	mädchen	OTHER
küchenmädchen	küche	mädchen	OTHER
maulwurfmädchen	maulwurf	mädchen	OTHER
novembermädchen	november	mädchen	OTHER
rosmarinmädchen	rosmarin	mädchen	OTHER
straßenmädchen	straße	mädchen	DEROGATORY
studentenmädchen	student	mädchen	OTHER
taximädchen	taxi	mädchen	OTHER
wolfsmädchen	wolf	mädchen	OTHER
zigarettenmädchen	zigarette	mädchen	OTHER
blechnase	blech	nase	OTHER
boxernase	boxer	nase	OTHER
butternase	butter	nase	OTHER
clownnase	clown	nase	OTHER
engelsnase	engel	nase	OTHER
fahrzeugnase	fahrzeug	nase	OTHER
hundenase	hund	nase	OTHER
kegelnase	kegel	nase	OTHER
kugelnase	kugel	nase	OTHER
lacknase	lack	nase	OTHER
plastiknase	plastik	nase	OTHER
raketennase	rakete	nase	OTHER
rattennase	ratte	nase	OTHER
rotznase	rotz	nase	DEROGATORY
rumpfnase	rumpf	nase	OTHER
rübennase	rübe	nase	DEROGATORY
schnupfennase	schnupfen	nase	OTHER
steinobstnase	steinobst	nase	OTHER
vermittlungsnase	vermittlung	nase	OTHER
versuchsnase	versuch	nase	OTHER
elfenohr	elfe	ohr	OTHER
eselsohr	esel	ohr	OTHER
herzohr	herz	ohr	OTHER
heuschreckenohr	heuschrecke	ohr	OTHER
hundeohr	hund	ohr	OTHER
judasohr	judas	ohr	OTHER
kamelohr	kamel	ohr	OTHER
kaninchenohr	kaninchen	ohr	OTHER
katzenohr	katze	ohr	OTHER
kunstohr	kunst	ohr	OTHER
laienohr	laie	ohr	OTHER
löwenohr	löwe	ohr	OTHER
menschenohr	mensch	ohr	OTHER
musikerohr	musiker	ohr	OTHER
plastikohr	plastik	ohr	OTHER
rinderohr	rind	ohr	OTHER
schlitzohr	schlitz	ohr	DEROGATORY
schweineohr	schwein	ohr	OTHER
sumpfohr	sumpf	ohr	OTHER
tierohr	tier	ohr	OTHER
arithmetik-paket	arithmetik	paket	OTHER
ausbildungspaket	ausbildung	paket	OTHER
beschlusspaket	beschluss	paket	OTHER
blätterteigpaket	blätterteig	paket	OTHER
care-paket	care	paket	OTHER
datenpaket	datum	paket	OTHER
einsteigerpaket	einsteiger	paket	OTHER
ekelpaket	ekel	paket	DEROGATORY
entwicklungspaket	entwicklung	paket	OTHER
fahrzeugpaket	fahrzeug	paket	OTHER
finanzpaket	finanz	paket	OTHER
flächenpaket	fläche	paket	OTHER
kanzleipaket	kanzlei	paket	OTHER
kraftpaket	kraft	paket	OTHER
lautsprecher-paket	lautsprecher	paket	OTHER
lunchpaket	lunch	paket	OTHER
rahmenpaket	rahmen	paket	OTHER
steiermark-paket	steiermark	paket	OTHER
versicherungspaket	versicherung	paket	OTHER
wortpaket	wort	paket	OTHER
cocktailpapst	cocktail	papst	OTHER
fitnesspapst	fitness	papst	OTHER
gastronomie-papst	gastronomie	papst	OTHER
humorpapst	humor	papst	OTHER
kaffeepapst	kaffee	papst	OTHER
management-papst	management	papst	OTHER
manierenpapst	manier	papst	OTHER
marketingpapst	marketing	papst	OTHER
medizinpapst	medizin	papst	OTHER
messepapst	messe	papst	OTHER
missions-papst	mission	papst	OTHER
modellbahnpapst	modellbahn	papst	OTHER
pop-papst	pop	papst	OTHER
pornopapst	porno	papst	DEROGATORY
solarpapst	solar	papst	OTHER
sonnenpapst	sonne	papst	OTHER
sängerpapst	sänger	papst	OTHER
taubenpapst	taube	papst	OTHER
testpapst	test	papst	OTHER
weinpapst	wein	papst	OTHER
bienenparasit	biene	parasit	OTHER
blutegelparasit	blutegel	parasit	OTHER
darmparasit	darm	parasit	OTHER
eingeweideparasit	eingeweide	parasit	OTHER
fischparasit	fisch	parasit	OTHER
futterparasit	futter	parasit	OTHER
geflügelparasit	geflügel	parasit	OTHER
gehirnparasit	gehirn	parasit	OTHER
gesellschafts-parasit	gesellschaft	parasit	DEROGATORY
hautparasit	haut	parasit	OTHER
katzenparasit	katze	parasit	OTHER
kiemenparasit	kieme	parasit	OTHER
magenparasit	magen	parasit	OTHER
maisparasit	mais	parasit	OTHER
malariaparasit	malaria	parasit	OTHER
nestparasit	nest	parasit	OTHER
robbenparasit	robbe	parasit	OTHER
schleimparasit	schleim	parasit	OTHER
schweineparasit	schwein	parasit	OTHER
staatsparasit	staat	parasit	DEROGATORY
berufspendlerparker	berufspendler	parker	OTHER
dauerparker	dauer	parker	OTHER
fahrradparker	fahrrad	parker	OTHER
garagenparker	garage	parker	OTHER
gehsteigparker	gehsteig	parker	OTHER
gehwegparker	gehweg	parker	OTHER
geldparker	geld	parker	OTHER
gleisparker	gleis	parker	OTHER
handyparker	handy	parker	OTHER
laternenparker	laterne	parker	OTHER
lkw-parker	lkw	parker	OTHER
messeparker	messe	parker	OTHER
nachbarparker	nachbar	parker	OTHER
nachtparker	nacht	parker	OTHER
radwegparker	radweg	parker	OTHER
rahmenparker	rahmen	parker	OTHER
schattenparker	schatten	parker	DEROGATORY
straßenparker	straße	parker	OTHER
tagesparker	tag	parker	OTHER
windschattenparker	windschatten	parker	DEROGATORY
birnenpflücker	birne	pflücker	DEROGATORY
blumenpflücker	blume	pflücker	DEROGATORY
blümchenpflücker	blümchen	pflücker	DEROGATORY
bärlauchpflücker	bärlauch	pflücker	OTHER
erbeerpflücker	erbeer	pflücker	OTHER
himbeerpflücker	himbeer	pflücker	OTHER
hopfenpflücker	hopfen	pflücker	OTHER
kaffeepflücker	kaffee	pflücker	OTHER
kakaopflücker	kakao	pflücker	OTHER
kirsch-pflücker	kirsch	pflücker	OTHER
knochenpflücker	knochen	pflücker	OTHER
lavendelpflücker	lavendel	pflücker	OTHER
obstpflücker	obst	pflücker	OTHER
orangenpflücker	orange	pflücker	OTHER
reispflücker	reis	pflücker	OTHER
sternepflücker	stern	pflücker	OTHER
tomatenpflücker	tomate	pflücker	OTHER
zapfenpflücker	zapfen	pflücker	OTHER
zitronenpflücker	zitrone	pflücker	OTHER
zwetschgenpflücker	zwetschge	pflücker	OTHER
berufsphilosoph	beruf	philosoph	OTHER
dichter-philosoph	dichter	philosoph	OTHER
exilphilosoph	exil	philosoph	OTHER
fachphilosoph	fach	philosoph	OTHER
fakultätsphilosoph	fakultät	philosoph	OTHER
gasthausphilosoph	gasthaus	philosoph	DEROGATORY
gegenwartsphilosoph	gegenwart	philosoph	OTHER
hindu-philosoph	hindu	philosoph	OTHER
lebensphilosoph	leben	philosoph	OTHER
musikphilosoph	musik	philosoph	OTHER
netzphilosoph	netz	philosoph	OTHER
parteiphilosoph	partei	philosoph	OTHER
ruhrgebietsphilosoph	ruhrgebiet	philosoph	OTHER
staatsphilosoph	staat	philosoph	OTHER
stammtischphilosoph	stammtisch	philosoph	DEROGATORY
vermittlungsphilosoph	vermittlung	philosoph	OTHER
wendephilosoph	wende	philosoph	DEROGATORY
wirtschaftsphilosoph	wirtschaft	philosoph	OTHER
zauberphilosoph	zauber	philosoph	OTHER
zen-philosoph	zen	philosoph	OTHER
akne-pickel	akne	pickel	OTHER
alkoholikerpickel	alkoholiker	pickel	DEROGATORY
eisenpickel	eisen	pickel	OTHER
eiterpickel	eiter	pickel	OTHER
elbenpickel	elb	pickel	OTHER
elefantenpickel	elefant	pickel	OTHER
fieberpickel	fieber	pickel	OTHER
glutpickel	glut	pickel	OTHER
handpickel	hand	pickel	OTHER
hautpickel	haut	pickel	OTHER
hitzepickel	hitze	pickel	OTHER
kalkpickel	kalk	pickel	OTHER
kraterpickel	krater	pickel	OTHER
monatspickel	monat	pickel	OTHER
mörderpickel	mörder	pickel	OTHER
nasenpickel	nase	pickel	OTHER
nusspickel	nuss	pickel	OTHER
rostpickel	rost	pickel	OTHER
silberpickel	silber	pickel	OTHER
sonnenallergiepickel	sonnenallergie	pickel	OTHER
auswahl-pinsel	auswahl	pinsel	OTHER
einfaltspinsel	einfalt	pinsel	DEROGATORY
fiberglaspinsel	fiberglas	pinsel	OTHER
flächenpinsel	fläche	pinsel	OTHER
kopierpinsel	kopier	pinsel	OTHER
lippenpinsel	lippe	pinsel	OTHER
mehltaupinsel	mehltau	pinsel	OTHER
motiv-pinsel	motiv	pinsel	OTHER
original-pinsel	original	pinsel	OTHER
puderpinsel	puder	pinsel	OTHER
qualitätspinsel	qualität	pinsel	OTHER
reisepinsel	reise	pinsel	OTHER
ringpinsel	ring	pinsel	OTHER
schreibpinsel	schreiben	pinsel	OTHER
strahlenpinsel	strahl	pinsel	OTHER
teerpinsel	teer	pinsel	OTHER
toilettenpinsel	toilette	pinsel	OTHER
tuschpinsel	tusch	pinsel	OTHER
weidenpinsel	weide	pinsel	OTHER
wolkenpinsel	wolke	pinsel	OTHER
chef-pirat	chef	pirat	OTHER
himmelspirat	himmel	pirat	OTHER
ideenpirat	idee	pirat	DEROGATORY
jahrgangspirat	jahrgang	pirat	OTHER
kunstpirat	kunst	pirat	OTHER
literaturpirat	literatur	pirat	OTHER
luftpirat	luft	pirat	OTHER
marspirat	mars	pirat	OTHER
nordseepirat	nordsee	pirat	OTHER
ostsee-pirat	ostsee	pirat	OTHER
periodenpirat	periode	pirat	DEROGATORY
radiopirat	radio	pirat	OTHER
raumpirat	raum	pirat	OTHER
skelettpirat	skelett	pirat	OTHER
strohhut-pirat	strohhut	pirat	OTHER
südseepirat	südsee	pirat	OTHER
teichpirat	teich	pirat	DEROGATORY
waldpirat	wald	pirat	OTHER
weltraum-pirat	weltraum	pirat	OTHER
zwergpirat	zwerg	pirat	OTHER
autopolierer	auto	polierer	OTHER
ballpolierer	ball	polierer	OTHER
chrompolierer	chrom	polierer	OTHER
erbseninnenwandpolierer	erbseninnenwand	polierer	DEROGATORY
felgenpolierer	felge	polierer	OTHER
gummipolierer	gummi	polierer	OTHER
handpolierer	hand	polierer	OTHER
hochglanzpolierer	hochglanz	polierer	OTHER
imagepolierer	image	polierer	OTHER
metallpolierer	metall	polierer	OTHER
möbelpolierer	möbel	polierer	OTHER
münzpolierer	münz	polierer	OTHER
nagelpolierer	nagel	polierer	OTHER
rotationspolierer	rotation	polierer	OTHER
rückspiegelpolierer	rückspiegel	polierer	DEROGATORY
schleifpolierer	schleif	polierer	OTHER
schwertpolierer	schwert	polierer	OTHER
silikonpolierer	silikon	polierer	OTHER
wildlederpolierer	wildleder	polierer	OTHER
winkelpolierer	winkel	polierer	OTHER
assistenzpriester	assistenz	priester	OTHER
bergpriester	berg	priester	OTHER
dominikanerpriester	dominikaner	priester	OTHER
geisterpriester	geist	priester	OTHER
hindupriester	hindu	priester	OTHER
indianerpriester	indianer	priester	OTHER
kardinalpriester	kardinal	priester	OTHER
königpriester	könig	priester	OTHER
leitungspriester	leitung	priester	OTHER
logenpriester	loge	priester	OTHER
nachwuchspriester	nachwuchs	priester	OTHER
orakelpriester	orakel	priester	OTHER
presbyterianer-priester	presbyterianer	priester	OTHER
radiopriester	radio	priester	OTHER
roma-priester	roma	priester	OTHER
schweinepriester	schwein	priester	DEROGATORY
unitarierpriester	unitarier	priester	OTHER
verbandspriester	verband	priester	OTHER
voodoo-priester	voodoo	priester	OTHER
zeuspriester	zeus	priester	OTHER
affenprinz	affe	prinz	DEROGATORY
drachenprinz	drache	prinz	OTHER
dämonprinz	dämon	prinz	OTHER
elfenprinz	elfe	prinz	OTHER
feenprinz	fee	prinz	OTHER
goldprinz	gold	prinz	OTHER
händler-prinz	händler	prinz	OTHER
kinderprinz	kind	prinz	OTHER
kriegerprinz	krieger	prinz	OTHER
marienkäfer-prinz	marienkäfer	prinz	OTHER
mongolen-prinz	mongole	prinz	OTHER
perserprinz	perser	prinz	OTHER
trollprinz	troll	prinz	OTHER
türkenprinz	türke	prinz	OTHER
vorjahrsprinz	vorjahr	prinz	OTHER
wikingerprinz	wikinger	prinz	OTHER
wunschprinz	wunsch	prinz	OTHER
wüstenprinz	wüst	prinz	OTHER
zauberprinz	zauber	prinz	OTHER
zwergenprinz	zwerg	prinz	OTHER
avantgarde-punk	avantgarde	punk	OTHER
brillenschlangenpunk	brillenschlange	punk	OTHER
comedy-punk	comedy	punk	OTHER
cowboy-punk	cowboy	punk	OTHER
dampfpunk	dampf	punk	OTHER
ddr-punk	ddr	punk	OTHER
england-punk	england	punk	OTHER
flaschenpunk	flasche	punk	OTHER
garagenpunk	garage	punk	OTHER
gymnasiastenpunk	gymnasiast	punk	OTHER
jazzpunk	jazz	punk	OTHER
klassikpunk	klassik	punk	OTHER
klischee-punk	klischee	punk	DEROGATORY
kopf-punk	kopf	punk	OTHER
popkultur-punk	popkultur	punk	OTHER
skate-punk	skat	punk	OTHER
skatpunk	skat	punk	OTHER
spaßpunk	spaß	punk	OTHER
straßenpunk	straße	punk	OTHER
surfpunk	surfen	punk	OTHER
adernputzer	ader	putzer	OTHER
algenputzer	alge	putzer	OTHER
autoputzer	auto	putzer	OTHER
bushaltestellenputzer	bushaltestelle	putzer	DEROGATORY
fensterputzer	fenster	putzer	OTHER
gemüseputzer	gemüse	putzer	OTHER
gussputzer	guss	putzer	OTHER
lampenputzer	lampe	putzer	OTHER
magenputzer	magen	putzer	OTHER
naseputzer	nase	putzer	OTHER
ohrenputzer	ohr	putzer	OTHER
panzerputzer	panzer	putzer	OTHER
pfeifenputzer	pfeife	putzer	OTHER
rachenputzer	rachen	putzer	OTHER
ringputzer	ring	putzer	OTHER
rohrputzer	rohr	putzer	OTHER
schuhputzer	schuh	putzer	OTHER
sternputzer	stern	putzer	OTHER
stiefelputzer	stiefel	putzer	OTHER
zungenputzer	zunge	putzer	OTHER
bergradler	berg	radler	OTHER
berufsradler	beruf	radler	OTHER
durchschnittsradler	durchschnitt	radler	OTHER
gehwegradler	gehweg	radler	DEROGATORY
gelegenheitsradler	gelegenheit	radler	OTHER
genussradler	genuss	radler	OTHER
igel-radler	igel	radler	OTHER
motorradler	motor	radler	OTHER
nachwuchs-radler	nachwuchs	radler	OTHER
reise-radler	reise	radler	OTHER
rekord-radler	rekord	radler	OTHER
sonntagsradler	sonntag	radler	OTHER
sportradler	sport	radler	OTHER
stadtradler	stadt	radler	OTHER
straßenradler	straße	radler	OTHER
städtepartnerschaftsradler	städtepartnerschaft	radler	OTHER
tandemradler	tandem	radler	OTHER
tourenradler	tour	radler	OTHER
weizen-radler	weizen	radler	OTHER
weltenradler	welt	radler	OTHER
akkurasierer	akku	rasierer	OTHER
augenbrauenrasierer	augenbraue	rasierer	OTHER
damenrasierer	dame	rasierer	OTHER
einwegrasierer	einweg	rasierer	OTHER
fusselrasierer	fusseln	rasierer	OTHER
herrenrasierer	herr	rasierer	OTHER
klingenrasierer	klinge	rasierer	OTHER
langhaarrasierer	langhaar	rasierer	OTHER
markenrasierer	marke	rasierer	OTHER
mehrklingenrasierer	mehrklinge	rasierer	OTHER
netzrasierer	netz	rasierer	OTHER
reiserasierer	reise	rasierer	OTHER
rückenrasierer	rücken	rasierer	OTHER
sackrasierer	sack	rasierer	DEROGATORY
schwingkopfrasierer	schwingkopf	rasierer	OTHER
sicherheitsrasierer	sicherheit	rasierer	OTHER
systemrasierer	system	rasierer	OTHER
wegwerfrasierer	wegwerf	rasierer	OTHER
wochenendrasierer	wochenend	rasierer	DEROGATORY
wollrasierer	woll	rasierer	OTHER
hirsch-reiter	hirsch	reiter	OTHER
jagdreiter	jagd	reiter	OTHER
kamelreiter	kamel	reiter	OTHER
kartonreiter	karton	reiter	OTHER
kniereiter	knie	reiter	OTHER
kurierreiter	kurier	reiter	OTHER
kübelreiter	kübel	reiter	OTHER
olympiareiter	olympia	reiter	OTHER
paragraphenreiter	paragraph	reiter	DEROGATORY
plattenreiter	platte	reiter	OTHER
postreiter	post	reiter	OTHER
schockwellenreiter	schockwelle	reiter	OTHER
seepferdchenreiter	seepferdchen	reiter	OTHER
siegreiter	sieg	reiter	OTHER
sportreiter	sport	reiter	OTHER
steppenreiter	steppe	reiter	OTHER
testreiter	test	reiter	OTHER
turnierreiter	turnier	reiter	OTHER
waldreiter	wald	reiter	OTHER
wellenreiter	welle	reiter	OTHER
alternative-rocker	alternative	rocker	OTHER
bluesrocker	blues	rocker	OTHER
country-rocker	country	rocker	OTHER
deutschrocker	deutsch	rocker	OTHER
dorfrocker	dorf	rocker	OTHER
folkrocker	folk	rocker	OTHER
gitarrenrocker	gitarre	rocker	OTHER
indie-rocker	indie	rocker	OTHER
krautrocker	kraut	rocker	OTHER
kultrocker	kult	rocker	OTHER
kölschrocker	kölsch	rocker	OTHER
mittelalter-rocker	mittelalter	rocker	OTHER
motorradrocker	motorrad	rocker	OTHER
panikrocker	panik	rocker	OTHER
punkrocker	punk	rocker	OTHER
ringrocker	ring	rocker	OTHER
sandkastenrocker	sandkasten	rocker	DEROGATORY
schockrocker	schock	rocker	OTHER
skandalrocker	skandal	rocker	OTHER
stadionrocker	stadion	rocker	OTHER
dattelsack	dattel	sack	OTHER
drecksack	dreck	sack	DEROGATORY
fahrradsack	fahrrad	sack	OTHER
fettsack	fett	sack	DEROGATORY
fruchtsack	frucht	sack	OTHER
getreidesack	getreide	sack	OTHER
goldsack	gold	sack	OTHER
hautsack	haut	sack	OTHER
hosensack	hose	sack	OTHER
kaffeesack	kaffee	sack	OTHER
kleidersack	kleid	sack	OTHER
kohlensack	kohle	sack	OTHER
kompressionssack	kompression	sack	OTHER
leinensack	leine	sack	OTHER
monstersack	monster	sack	OTHER
müllsack	müll	sack	OTHER
schafsack	schaf	sack	OTHER
schlafsack	schlaf	sack	OTHER
spielzeugsack	spielzeug	sack	OTHER
wertstoffsack	wertstoff	sack	OTHER
arabersau	araber	sau	DEROGATORY
ausländersau	ausländer	sau	DEROGATORY
bergsau	berg	sau	OTHER
bullensau	bulle	sau	DEROGATORY
dinosau	dino	sau	OTHER
drecksau	dreck	sau	DEROGATORY
fettsau	fett	sau	DEROGATORY
frontsau	front	sau	OTHER
gummisau	gummi	sau	OTHER
krustensau	kruste	sau	OTHER
mastsau	mast	sau	OTHER
modellsau	modell	sau	OTHER
ofensau	ofen	sau	OTHER
pistensau	piste	sau	DEROGATORY
pottsau	pott	sau	DEROGATORY
rassensau	rasse	sau	DEROGATORY
trüffelsau	trüffel	sau	OTHER
umweltsau	umwelt	sau	DEROGATORY
vollmilchsau	vollmilch	sau	OTHER
warzensau	warze	sau	OTHER
bergschaf	berg	schaf	OTHER
eierschaf	ei	schaf	OTHER
filmschaf	film	schaf	OTHER
fleischschaf	fleisch	schaf	OTHER
handpuppenschaf	handpuppe	schaf	OTHER
heidenschaf	heide	schaf	OTHER
killerschaf	killer	schaf	OTHER
kunststoffschaf	kunststoff	schaf	OTHER
mastschaf	mast	schaf	OTHER
meisterschaf	meister	schaf	OTHER
mondschaf	mond	schaf	OTHER
panda-schaf	panda	schaf	OTHER
perückenschaf	perücke	schaf	DEROGATORY
schneeschaf	schnee	schaf	OTHER
stuntschaf	stunt	schaf	OTHER
traumschaf	traum	schaf	OTHER
unternehmerschaf	unternehmer	schaf	OTHER
versuchsschaf	versuch	schaf	OTHER
weihnachtsschaf	weihnacht	schaf	OTHER
zuchtschaf	zucht	schaf	OTHER
asphaltschleicher	asphalt	schleicher	DEROGATORY
dielenschleicher	diele	schleicher	OTHER
eckenschleicher	ecke	schleicher	OTHER
ego-schleicher	ego	schleicher	OTHER
erbschleicher	erben	schleicher	DEROGATORY
heckenschleicher	hecke	schleicher	OTHER
korkschleicher	kork	schleicher	OTHER
landschleicher	land	schleicher	OTHER
leichenschleicher	leiche	schleicher	OTHER
meisterschleicher	meister	schleicher	OTHER
profilschleicher	profil	schleicher	OTHER
quotenschleicher	quote	schleicher	OTHER
rabatt-schleicher	rabatt	schleicher	DEROGATORY
rheinschleicher	rhein	schleicher	OTHER
schneeschleicher	schnee	schleicher	OTHER
stadtschleicher	stadt	schleicher	OTHER
tunnelschleicher	tunnel	schleicher	OTHER
waldschleicher	wald	schleicher	OTHER
wasserschleicher	wasser	schleicher	OTHER
wüstenschleicher	wüst	schleicher	OTHER
baumschleuder	baum	schleuder	OTHER
bleischleuder	blei	schleuder	OTHER
dioxinschleuder	dioxin	schleuder	OTHER
dreckschleuder	dreck	schleuder	DEROGATORY
elektronenschleuder	elektron	schleuder	OTHER
endorphinschleuder	endorphin	schleuder	OTHER
gummischleuder	gummi	schleuder	OTHER
handschleuder	hand	schleuder	OTHER
honigschleuder	honig	schleuder	OTHER
madenschleuder	made	schleuder	OTHER
milchschleuder	milch	schleuder	OTHER
plutoniumschleuder	plutonium	schleuder	OTHER
präzisionsschleuder	präzision	schleuder	OTHER
schafschleuder	schaf	schleuder	OTHER
schneckenschleuder	schnecke	schleuder	OTHER
speerschleuder	speer	schleuder	OTHER
steinschleuder	stein	schleuder	OTHER
strahlenschleuder	strahl	schleuder	OTHER
techno-schleuder	techno	schleuder	OTHER
wäscheschleuder	wäsche	schleuder	OTHER
abfall-schlucker	abfall	schlucker	OTHER
benzinschlucker	benzin	schlucker	OTHER
co2-schlucker	co2	schlucker	OTHER
degenschlucker	degen	schlucker	OTHER
düngerschlucker	dünger	schlucker	OTHER
geruchsschlucker	geruch	schlucker	OTHER
hakenschlucker	haken	schlucker	OTHER
hardwareschlucker	hardware	schlucker	OTHER
lastenschlucker	last	schlucker	OTHER
medikamentenschlucker	medikament	schlucker	OTHER
messerschlucker	messer	schlucker	OTHER
modulschlucker	modul	schlucker	OTHER
münzenschlucker	münze	schlucker	OTHER
schadstoffschlucker	schadstoff	schlucker	OTHER
schwertschlucker	schwert	schlucker	OTHER
sonnenschlucker	sonne	schlucker	OTHER
spritschlucker	sprit	schlucker	OTHER
taschengeldschlucker	taschengeld	schlucker	OTHER
viagraschlucker	viagra	schlucker	DEROGATORY
zeitschlucker	zeit	schlucker	OTHER
bühnenschlund	bühne	schlund	OTHER
felsenschlund	felsen	schlund	OTHER
gierschlund	gier	schlund	DEROGATORY
hadesschlund	hades	schlund	OTHER
höhlenschlund	höhle	schlund	OTHER
krötenschlund	kröte	schlund	OTHER
kühlerschlund	kühler	schlund	OTHER
lasterschlund	laster	schlund	OTHER
löwenschlund	löwe	schlund	OTHER
magenschlund	magen	schlund	OTHER
meerschlund	meer	schlund	OTHER
monsterschlund	monster	schlund	OTHER
schattenschlund	schatten	schlund	OTHER
schwefelschlund	schwefel	schlund	OTHER
stoffschlund	stoff	schlund	OTHER
stollenschlund	stollen	schlund	OTHER
tankschlund	tank	schlund	OTHER
teufelsschlund	teufel	schlund	OTHER
tunnelschlund	tunnel	schlund	OTHER
wasserschlund	wasser	schlund	OTHER
beutelschneider	beutel	schneider	DEROGATORY
bolzenschneider	bolzen	schneider	OTHER
bretschneider	bret	schneider	OTHER
dorfschneider	dorf	schneider	OTHER
drahtschneider	draht	schneider	OTHER
fadenschneider	faden	schneider	OTHER
formschneider	form	schneider	OTHER
heckenschneider	hecke	schneider	OTHER
krautschneider	kraut	schneider	OTHER
lagerschneider	lager	schneider	OTHER
langhaarschneider	langhaar	schneider	OTHER
palastschneider	palast	schneider	OTHER
pizzaschneider	pizza	schneider	OTHER
rohrschneider	rohr	schneider	OTHER
runenschneider	rune	schneider	OTHER
scherenschneider	schere	schneider	OTHER
seitenschneider	seite	schneider	OTHER
strohschneider	stroh	schneider	OTHER
trachtenschneider	tracht	schneider	OTHER
zentrumsschneider	zentrum	schneider	OTHER
belastungsschraube	belastung	schraube	OTHER
blattschraube	blatt	schraube	OTHER
blechschraube	blech	schraube	OTHER
drehwinkelschraube	drehwinkel	schraube	OTHER
entlüftungsschraube	entlüftung	schraube	OTHER
gewindeschraube	gewinde	schraube	OTHER
kreuzschraube	kreuz	schraube	OTHER
kunststoffschraube	kunststoff	schraube	OTHER
mauerwerkschraube	mauerwerk	schraube	OTHER
ritzelschraube	ritzel	schraube	OTHER
schiffschraube	schiff	schraube	OTHER
schreckschraube	schreck	schraube	DEROGATORY
schwellenschraube	schwelle	schraube	OTHER
selektionsschraube	selektion	schraube	OTHER
spanplatten-schraube	spanplatte	schraube	OTHER
ventilschraube	ventil	schraube	OTHER
verriegelungsschraube	verriegelung	schraube	OTHER
versorgungsschraube	versorgung	schraube	OTHER
wertschraube	wert	schraube	OTHER
winkelschraube	winkel	schraube	OTHER
baumschubser	baum	schubser	OTHER
bierschubser	bier	schubser	DEROGATORY
bleistiftschubser	bleistift	schubser	OTHER
dackelschubser	dackel	schubser	DEROGATORY
ellenbogenschubser	ellenbogen	schubser	DEROGATORY
glasschubser	glas	schubser	OTHER
kistenschubser	kiste	schubser	OTHER
knieschubser	knie	schubser	OTHER
matrizenschubser	matrix	schubser	OTHER
mausschubser	maus	schubser	DEROGATORY
muschelschubser	muschel	schubser	DEROGATORY
panzerschubser	panzer	schubser	OTHER
pixelschubser	pixel	schubser	DEROGATORY
revancheschubser	revanche	schubser	OTHER
s-bahn-schubser	sbahn	schubser	OTHER
saftschubse	saf	schubser	DEROGATORY
schafschubser	schaf	schubser	OTHER
seitenschubser	seite	schubser	OTHER
straßenbahnschubser	straßenbahn	schubser	OTHER
u-bahn-schubser	ubahn	schubser	OTHER
bayern-schwalbe	bayern	schwalbe	OTHER
blitzschwalbe	blitz	schwalbe	OTHER
bordsteinschwalbe	bordstein	schwalbe	DEROGATORY
brandschwalbe	brand	schwalbe	OTHER
cdu-schwalbe	cdu	schwalbe	OTHER
felsenschwalbe	felsen	schwalbe	OTHER
frühjahrsschwalbe	frühjahr	schwalbe	OTHER
hausschwalbe	haus	schwalbe	OTHER
kanzelschwalbe	kanzel	schwalbe	DEROGATORY
küstenschwalbe	küste	schwalbe	OTHER
mahlschwalbe	mahl	schwalbe	OTHER
mauerschwalbe	mauer	schwalbe	OTHER
meerschwalbe	meer	schwalbe	OTHER
mehlschwalbe	mehl	schwalbe	OTHER
papierschwalbe	papier	schwalbe	OTHER
rauschschwalbe	rausch	schwalbe	OTHER
sommerschwalbe	sommer	schwalbe	OTHER
turmschwalbe	turm	schwalbe	OTHER
wasserschwalbe	wasser	schwalbe	OTHER
zwergschwalbe	zwerg	schwalbe	OTHER
charakterschwein	charakter	schwein	DEROGATORY
chefschwein	chef	schwein	OTHER
eberschwein	eber	schwein	OTHER
egoistenschwein	egoist	schwein	DEROGATORY
feldschwein	feld	schwein	OTHER
frontschwein	front	schwein	OTHER
kameradenschwein	kamerad	schwein	DEROGATORY
klonschwein	klonen	schwein	OTHER
lästerschwein	läster	schwein	DEROGATORY
marzipanschwein	marzipan	schwein	OTHER
maskenschwein	maske	schwein	OTHER
milchschwein	milch	schwein	OTHER
miniaturschwein	miniatur	schwein	OTHER
osterschwein	oster	schwein	OTHER
spenderschwein	spender	schwein	OTHER
stoffschwein	stoff	schwein	OTHER
verräterschwein	verräter	schwein	DEROGATORY
waldschwein	wald	schwein	OTHER
wildschwein	wild	schwein	OTHER
zuchtschwein	zucht	schwein	OTHER
amtsschwester	amt	schwester	OTHER
anästhesieschwester	anästhesie	schwester	OTHER
armenschwester	arm	schwester	OTHER
babyschwester	baby	schwester	OTHER
diakonie-schwester	diakonie	schwester	OTHER
fotoschwester	foto	schwester	OTHER
gastschwester	gast	schwester	OTHER
häkelschwester	häkel	schwester	DEROGATORY
krankenschwester	kranke	schwester	OTHER
menschenschwester	mensch	schwester	OTHER
muslim-schwester	muslim	schwester	OTHER
operationsschwester	operation	schwester	OTHER
pensionsschwester	pension	schwester	OTHER
prophylaxeschwester	prophylaxe	schwester	OTHER
richterschwester	richter	schwester	OTHER
rock-schwester	rock	schwester	OTHER
schulungsschwester	schulung	schwester	OTHER
spiegelschwester	spiegel	schwester	OTHER
weinschwester	wein	schwester	OTHER
zofenschwester	zofe	schwester	OTHER
abenteuerschwimmer	abenteuer	schwimmer	OTHER
ausnahme-schwimmer	ausnahme	schwimmer	OTHER
beckenrandschwimmer	beckenrand	schwimmer	DEROGATORY
brustschwimmer	brust	schwimmer	OTHER
delphinschwimmer	delphin	schwimmer	OTHER
freistilschwimmer	freistil	schwimmer	OTHER
hochleistungsschwimmer	hochleistung	schwimmer	OTHER
hochseeschwimmer	hochsee	schwimmer	OTHER
kork-schwimmer	kork	schwimmer	OTHER
kugelschwimmer	kugel	schwimmer	OTHER
kurzstreckenschwimmer	kurzstrecke	schwimmer	OTHER
meerwasserschwimmer	meerwasser	schwimmer	OTHER
meisterschwimmer	meister	schwimmer	OTHER
nachwuchsschwimmer	nachwuchs	schwimmer	OTHER
netzschwimmer	netz	schwimmer	OTHER
olympiaschwimmer	olympia	schwimmer	OTHER
rekord-schwimmer	rekord	schwimmer	OTHER
rücken-schwimmer	rücken	schwimmer	OTHER
sportschwimmer	sport	schwimmer	OTHER
wasserfreunde-schwimmer	wasserfreund	schwimmer	OTHER
beilschwinger	beil	schwinger	OTHER
besenschwinger	besen	schwinger	OTHER
biegeschwinger	biege	schwinger	OTHER
fackelschwinger	fackel	schwinger	OTHER
fahnenschwinger	fahne	schwinger	OTHER
gitarrenschwinger	gitarre	schwinger	OTHER
hammerschwinger	hammer	schwinger	OTHER
knüppelschwinger	knüppel	schwinger	DEROGATORY
lianenschwinger	liane	schwinger	OTHER
löffelschwinger	löffel	schwinger	OTHER
messerschwinger	messer	schwinger	OTHER
morgensternschwinger	morgenstern	schwinger	OTHER
nadelschwinger	nadel	schwinger	OTHER
peitschenschwinger	peitsche	schwinger	OTHER
reifenschwinger	reifen	schwinger	OTHER
revolverschwinger	revolver	schwinger	OTHER
rotationsschwinger	rotation	schwinger	OTHER
strahlschwinger	strahl	schwinger	OTHER
säbelschwinger	säbel	schwinger	OTHER
torsionsschwinger	torsion	schwinger	OTHER
ananasschäler	ananas	schäler	OTHER
apfelschäler	apfel	schäler	OTHER
apfelsinenschäler	apfelsine	schäler	OTHER
bananenschäler	banane	schäler	OTHER
dampfschäler	dampf	schäler	OTHER
gemüseschäler	gemüse	schäler	OTHER
gurkenschäler	gurke	schäler	DEROGATORY
hirseschäler	hirse	schäler	OTHER
karottenschäler	karotte	schäler	OTHER
kartoffelschäler	kartoffel	schäler	OTHER
korkeichenschäler	korkeiche	schäler	OTHER
korkschäler	kork	schäler	OTHER
laugenschäler	lauge	schäler	OTHER
limonischäler	limoni	schäler	OTHER
möhrenschäler	möhre	schäler	OTHER
obstschäler	obst	schäler	OTHER
orangenschäler	orange	schäler	OTHER
rindenschäler	rinde	schäler	OTHER
spargelschäler	spargel	schäler	OTHER
zwiebelschäler	zwiebel	schäler	OTHER
familienschänder	familie	schänder	DEROGATORY
frauenschänder	frau	schänder	OTHER
friedhofschänder	friedhof	schänder	OTHER
grabschänder	grab	schänder	OTHER
heiligtumesschänder	heiligtum	schänder	OTHER
heiligtumsschänder	heiligtum	schänder	OTHER
hostienschänder	hostie	schänder	OTHER
hundeschänder	hund	schänder	OTHER
katzenschänder	katze	schänder	OTHER
kinderschänder	kind	schänder	OTHER
kirchenschänder	kirche	schänder	OTHER
leichenschänder	leiche	schänder	OTHER
mumienschänder	mumie	schänder	OTHER
naturschänder	natur	schänder	DEROGATORY
pferdeschänder	pferd	schänder	OTHER
robbenschänder	robbe	schänder	OTHER
sabbathsschänder	sabbath	schänder	OTHER
schafschänder	schaf	schänder	OTHER
tempelschänder	tempel	schänder	OTHER
umweltschänder	umwelt	schänder	DEROGATORY
baumschüttler	baum	schüttler	OTHER
beuteschüttler	beute	schüttler	OTHER
bodenschüttler	boden	schüttler	OTHER
butterschüttler	butter	schüttler	OTHER
glockenschüttler	glocke	schüttler	OTHER
haareschüttler	haar	schüttler	OTHER
handschüttler	hand	schüttler	OTHER
hydraulikschüttler	hydraulik	schüttler	OTHER
knochenschüttler	knochen	schüttler	OTHER
kopfschüttler	kopf	schüttler	OTHER
mattenschüttler	matte	schüttler	OTHER
nackenschüttler	nacken	schüttler	OTHER
obstschüttler	obst	schüttler	OTHER
olivenschüttler	olive	schüttler	OTHER
palmenschüttler	palme	schüttler	DEROGATORY
rübenschüttler	rübe	schüttler	OTHER
seilschüttler	seil	schüttler	OTHER
speerschüttler	speer	schüttler	OTHER
witwenschüttler	witwe	schüttler	DEROGATORY
zitronenschüttler	zitrone	schüttler	DEROGATORY
atomseele	atom	seele	OTHER
christenseele	christ	seele	OTHER
elefantenseele	elefant	seele	OTHER
frauenseele	frau	seele	OTHER
gartenseele	garten	seele	OTHER
glockenseele	glocke	seele	OTHER
goldseele	gold	seele	OTHER
gruppenseele	gruppe	seele	OTHER
hasen-seele	hase	seele	OTHER
hunde-seele	hund	seele	OTHER
kinderseele	kind	seele	OTHER
krämerseele	krämer	seele	DEROGATORY
körperseele	körper	seele	OTHER
puppenseele	puppe	seele	OTHER
schriftstellerseele	schriftsteller	seele	OTHER
schwesterseele	schwester	seele	OTHER
schüler-seele	schüler	seele	OTHER
tierseele	tier	seele	OTHER
unternehmerseele	unternehmer	seele	OTHER
wanderseele	wandern	seele	OTHER
alpensegler	alp	segler	OTHER
bavaria-segler	bavaria	segler	OTHER
dornensegler	dorn	segler	OTHER
drachensegler	drache	segler	OTHER
frachtensegler	fracht	segler	OTHER
haussegler	haus	segler	OTHER
hochseesegler	hochsee	segler	OTHER
jollensegler	jolle	segler	OTHER
katamaransegler	katamaran	segler	OTHER
kreuzfahrtsegler	kreuzfahrt	segler	OTHER
küstensegler	küste	segler	OTHER
nachbarsegler	nachbar	segler	OTHER
nachwuchssegler	nachwuchs	segler	OTHER
nordseesegler	nordsee	segler	OTHER
postsegler	post	segler	OTHER
raumsegler	raum	segler	OTHER
sonar-segler	sonar	segler	OTHER
süßwassersegler	süßwasser	segler	DEROGATORY
transportsegler	transport	segler	OTHER
windsegler	wind	segler	OTHER
arbeitsklave	arbeit	sklave	OTHER
bergarbeitersklave	bergarbeiter	sklave	OTHER
bergwerkssklave	bergwerk	sklave	OTHER
billiglohnsklave	billiglohn	sklave	OTHER
boardsklave	board	sklave	OTHER
dämonensklave	dämon	sklave	OTHER
fabriksklave	fabrik	sklave	OTHER
fließbandsklave	fließband	sklave	OTHER
goldgräbersklave	goldgrab	sklave	OTHER
haussklave	haus	sklave	OTHER
häftlingssklave	häftling	sklave	OTHER
kampfsklave	kampf	sklave	OTHER
koch-sklave	koch	sklave	OTHER
konsumsklave	konsum	sklave	DEROGATORY
küchensklave	küche	sklave	OTHER
lohnsklave	lohn	sklave	OTHER
menschensklave	mensch	sklave	OTHER
robotersklave	roboter	sklave	OTHER
stadtsklave	stadt	sklave	OTHER
weinbergssklave	weinberg	sklave	OTHER
eiweißspalter	eiweiß	spalter	OTHER
felsenspalter	felsen	spalter	OTHER
formaldehydabspalter	formaldehydab	spalter	OTHER
haarspalter	haar	spalter	DEROGATORY
helmspalter	helm	spalter	OTHER
hochleistungsspalter	hochleistung	spalter	OTHER
kalorienspalter	kalorie	spalter	OTHER
kernspalter	kern	spalter	OTHER
kirchenspalter	kirche	spalter	OTHER
kümmelspalter	kümmel	spalter	DEROGATORY
nebelspalter	nebel	spalter	OTHER
parteispalter	partei	spalter	OTHER
platinspalter	platin	spalter	OTHER
rindenspalter	rinde	spalter	OTHER
schieferspalter	schiefer	spalter	OTHER
schädelspalter	schädel	spalter	OTHER
steinspalter	stein	spalter	OTHER
stärkespalter	stärke	spalter	OTHER
weltenspalter	welt	spalter	OTHER
zeitspalter	zeit	spalter	OTHER
apfelspatz	apfel	spatz	OTHER
buschspatz	busch	spatz	OTHER
dreckspatz	dreck	spatz	DEROGATORY
eifelspatz	eifel	spatz	OTHER
feldspatz	feld	spatz	OTHER
ferienspatz	ferien	spatz	OTHER
flugplatzspatz	flugplatz	spatz	OTHER
friedensspatz	frieden	spatz	OTHER
futter-spatz	futter	spatz	OTHER
goldspatz	gold	spatz	OTHER
großstadtspatz	großstadt	spatz	OTHER
krautspatz	kraut	spatz	OTHER
kringelspatz	kringel	spatz	OTHER
käsespatz	käse	spatz	OTHER
mehlspatz	mehl	spatz	OTHER
ochsenspatz	ochse	spatz	OTHER
rohrspatz	rohr	spatz	OTHER
straßenspatz	straße	spatz	OTHER
weihnachtsspatz	weihnacht	spatz	OTHER
wetterspatz	wetter	spatz	OTHER
ameisenspecht	ameise	specht	OTHER
bergspecht	berg	specht	OTHER
betonspecht	beton	specht	OTHER
blutspecht	blut	specht	OTHER
eichelspecht	eichel	specht	OTHER
elfenbeinspecht	elfenbein	specht	OTHER
genussspecht	genuss	specht	OTHER
goldspecht	gold	specht	OTHER
hackspecht	hacken	specht	OTHER
helmspecht	helm	specht	OTHER
herrenspecht	herr	specht	OTHER
mauerspecht	mauer	specht	OTHER
rohrspecht	rohr	specht	OTHER
schluckspecht	schluck	specht	DEROGATORY
schneespecht	schnee	specht	OTHER
spielzeugspecht	spielzeug	specht	OTHER
sportspecht	sport	specht	OTHER
sultanspecht	sultan	specht	OTHER
waldspecht	wald	specht	OTHER
zahnstocherspecht	zahnstocher	specht	OTHER
dosenspender	dose	spender	OTHER
geldspender	geld	spender	OTHER
glühwein-spender	glühwein	spender	OTHER
hirnspender	hirn	spender	DEROGATORY
keksspender	keks	spender	OTHER
kohlenhydrate-spender	kohlenhydrat	spender	OTHER
kohlspender	kohl	spender	OTHER
kältespender	kälte	spender	OTHER
medikamentenspender	medikament	spender	OTHER
organspender	organ	spender	OTHER
shampoo-spender	shampoo	spender	OTHER
stammzellenspender	stammzelle	spender	OTHER
stromspender	strom	spender	OTHER
süßstoffspender	süßstoff	spender	OTHER
trostspender	trost	spender	OTHER
tütenspender	tüte	spender	OTHER
vitaminspender	vitamin	spender	OTHER
wahlspender	wahl	spender	OTHER
wasserspender	wasser	spender	OTHER
wärmespender	wärme	spender	OTHER
alkoholspritzer	alkohol	spritzer	OTHER
blutzspritzer	blutz	spritzer	OTHER
drogenspritzer	droge	spritzer	OTHER
farbenspritzer	farbe	spritzer	OTHER
fettspritzer	fett	spritzer	OTHER
insektizidspritzer	insektizid	spritzer	OTHER
kalkspritzer	kalk	spritzer	OTHER
lackspritzer	lack	spritzer	OTHER
lichtspritzer	licht	spritzer	OTHER
regenspritzer	regen	spritzer	OTHER
saftspritzer	saft	spritzer	OTHER
sahnespritzer	sahne	spritzer	OTHER
salzspritzer	salz	spritzer	OTHER
salzwasser-spritzer	salzwasser	spritzer	OTHER
sektspritzer	sekt	spritzer	OTHER
senfspritzer	senf	spritzer	OTHER
spermaspritzer	sperma	spritzer	DEROGATORY
tintenspritzer	tinte	spritzer	OTHER
wachsspritzer	wachs	spritzer	OTHER
weihwasserspritzer	weihwasser	spritzer	OTHER
abseitssteher	abseits	steher	OTHER
amateursteher	amateur	steher	OTHER
begrenzungssteher	begrenzung	steher	OTHER
betonsteher	beton	steher	OTHER
gangsteher	gang	steher	OTHER
holzsteher	holz	steher	OTHER
kopfsteher	kopf	steher	OTHER
leitplankensteher	leitplanke	steher	OTHER
leitungssteher	leitung	steher	DEROGATORY
modellsteher	modell	steher	OTHER
postensteher	posten	steher	OTHER
schlangesteher	schlange	steher	OTHER
schmiere-steher	schmiere	steher	OTHER
stausteher	stau	steher	OTHER
stimmungssteher	stimmung	steher	OTHER
thekensteher	theke	steher	OTHER
türsteher	türe	steher	OTHER
wandsteher	wand	steher	OTHER
wintersteher	winter	steher	OTHER
zaunsteher	zaun	steher	OTHER
bilderstürmer	bild	stürmer	OTHER
chartstürmer	chart	stürmer	OTHER
cottbus-stürmer	cottbus	stürmer	OTHER
denkmalsstürmer	denkmal	stürmer	OTHER
durchschnittsstürmer	durchschnitt	stürmer	OTHER
dänen-stürmer	däne	stürmer	OTHER
flügelstürmer	flügel	stürmer	OTHER
gardestürmer	garde	stürmer	OTHER
gipfelstürmer	gipfel	stürmer	OTHER
haie-stürmer	hai	stürmer	OTHER
himmelstürmer	himmel	stürmer	OTHER
hockey-stürmer	hockey	stürmer	OTHER
holland-stürmer	holland	stürmer	OTHER
reserve-stürmer	reserve	stürmer	OTHER
schlüpferstürmer	schlüpfer	stürmer	DEROGATORY
star-stürmer	star	stürmer	OTHER
strafraumstürmer	strafraum	stürmer	OTHER
tempelstürmer	tempel	stürmer	OTHER
verbandsligastürmer	verbandsliga	stürmer	OTHER
wunderstürmer	wunder	stürmer	OTHER
baumsäge	baum	säge	OTHER
brettersäge	brett	säge	OTHER
brettsäge	brett	säge	OTHER
gattersäge	gatter	säge	OTHER
gratsäge	grat	säge	OTHER
handsäge	hand	säge	OTHER
heimwerkersäge	heimwerker	säge	OTHER
holz-säge	holz	säge	OTHER
innenausbausäge	innenausbau	säge	OTHER
japansäge	japan	säge	OTHER
kettensäge	kette	säge	OTHER
kreischsäge	kreischen	säge	OTHER
krokodilsäge	krokodil	säge	OTHER
laubsäge	laub	säge	OTHER
nervensäge	nerv	säge	DEROGATORY
schlitzsäge	schlitz	säge	OTHER
schrotsäge	schrot	säge	OTHER
seilsäge	seil	säge	OTHER
steinsäge	stein	säge	OTHER
uhrmachersäge	uhrmacher	säge	OTHER
basteltante	basteln	tante	OTHER
briefkastentante	briefkasten	tante	DEROGATORY
familientante	familie	tante	OTHER
friesentante	fries	tante	OTHER
jugendamttante	jugendamt	tante	DEROGATORY
kindergarten-tante	kindergarten	tante	DEROGATORY
kindertante	kind	tante	OTHER
kitsch-tante	kitsch	tante	DEROGATORY
klatschtante	klatsch	tante	DEROGATORY
kuchentante	kuchen	tante	OTHER
kummerkastentante	kummerkasten	tante	DEROGATORY
lufthansa-tante	lufthansa	tante	DEROGATORY
patentante	pate	tante	OTHER
promitante	promi	tante	OTHER
reisebürotante	reisebüro	tante	DEROGATORY
rätseltante	rätsel	tante	OTHER
sorgentante	sorge	tante	OTHER
sparkassentante	sparkasse	tante	DEROGATORY
stadttante	stadt	tante	OTHER
tratschtante	tratsch	tante	DEROGATORY
auftragsterrorist	auftrag	terrorist	OTHER
aushilfsterrorist	aushilfe	terrorist	DEROGATORY
chefterrorist	chef	terrorist	OTHER
dschihad-terrorist	dschihad	terrorist	OTHER
flugzeug-terrorist	flugzeug	terrorist	OTHER
friedensterrorist	frieden	terrorist	OTHER
gästebuch-terrorist	gästebuch	terrorist	DEROGATORY
handyterrorist	handy	terrorist	OTHER
islam-terrorist	islam	terrorist	OTHER
luftterrorist	luft	terrorist	OTHER
moslemterrorist	moslem	terrorist	OTHER
müllterrorist	müll	terrorist	DEROGATORY
nachwuchsterrorist	nachwuchs	terrorist	DEROGATORY
raf-terrorist	raf	terrorist	OTHER
rasenmäherterrorist	rasenmäher	terrorist	DEROGATORY
selbstmord-terrorist	selbstmord	terrorist	OTHER
staatsterrorist	staat	terrorist	OTHER
straßenterrorist	straße	terrorist	DEROGATORY
usa-terrorist	usa	terrorist	OTHER
west-terrorist	west	terrorist	OTHER
beutetier	beute	tier	OTHER
fantasietier	fantasie	tier	OTHER
haustier	haus	tier	OTHER
horoskoptier	horoskop	tier	OTHER
lusttier	lust	tier	OTHER
milchtier	milch	tier	OTHER
mustertier	muster	tier	OTHER
nahrungstier	nahrung	tier	OTHER
nutztier	nutz	tier	OTHER
opfertier	opfer	tier	OTHER
raubtier	raub	tier	OTHER
reittier	reit	tier	OTHER
schlachttier	schlacht	tier	OTHER
schweißtier	schweiß	tier	DEROGATORY
sommertier	sommer	tier	OTHER
stofftier	stoff	tier	OTHER
versuchstier	versuch	tier	OTHER
wildfangtier	wildfang	tier	OTHER
wirbeltier	wirbel	tier	OTHER
zirkusstier	zirkuss	tier	OTHER
armeetrompeter	armee	trompeter	OTHER
ausnahmetrompeter	ausnahme	trompeter	OTHER
barocktrompeter	barock	trompeter	OTHER
bebop-trompeter	bebop	trompeter	OTHER
fan-trompeter	fan	trompeter	OTHER
gasttrompeter	gast	trompeter	OTHER
hosentrompeter	hose	trompeter	DEROGATORY
jazztrompeter	jazz	trompeter	OTHER
kavallerietrompeter	kavallerie	trompeter	OTHER
laientrompeter	laie	trompeter	OTHER
landtrompeter	land	trompeter	OTHER
moral-trompeter	moral	trompeter	DEROGATORY
nachwuchs-trompeter	nachwuchs	trompeter	OTHER
orchestertrompeter	orchester	trompeter	OTHER
phrasentrompeter	phrase	trompeter	DEROGATORY
signaltrompeter	signal	trompeter	OTHER
stabstrompeter	stab	trompeter	OTHER
stadttrompeter	stadt	trompeter	OTHER
teufelstrompeter	teufel	trompeter	OTHER
volksmusik-trompeter	volksmusik	trompeter	OTHER
besatzungstruppe	besatzung	truppe	OTHER
bodentruppe	boden	truppe	OTHER
einsatztruppe	einsatz	truppe	OTHER
elitetruppe	elite	truppe	OTHER
friedenstruppe	frieden	truppe	OTHER
grenztruppe	grenz	truppe	OTHER
gurkentruppe	gurke	truppe	DEROGATORY
hilfstruppe	hilf	truppe	OTHER
kampftruppe	kampf	truppe	OTHER
kerntruppe	kern	truppe	OTHER
koalitionstruppe	koalition	truppe	OTHER
nato-truppe	nato	truppe	OTHER
panzertruppe	panzer	truppe	OTHER
polizeitruppe	polizei	truppe	OTHER
regierungstruppe	regierung	truppe	OTHER
schlägertruppe	schläger	truppe	OTHER
schutztruppe	schutz	truppe	OTHER
sturmtruppe	sturm	truppe	OTHER
söldnertruppe	söldner	truppe	OTHER
theatertruppe	theater	truppe	OTHER
bauchtänzer	bauch	tänzer	OTHER
bühnentänzer	bühne	tänzer	OTHER
discotänzer	disco	tänzer	OTHER
flamenco-tänzer	flamenco	tänzer	OTHER
folkloretänzer	folklore	tänzer	OTHER
formationstänzer	formation	tänzer	OTHER
hobby-tänzer	hobby	tänzer	OTHER
kämpfer-tänzer	kämpfer	tänzer	OTHER
marathontänzer	marathon	tänzer	OTHER
salsa-tänzer	salsa	tänzer	OTHER
sambatänzer	samba	tänzer	OTHER
schattentänzer	schatten	tänzer	OTHER
seiltänzer	seil	tänzer	OTHER
standardtänzer	standard	tänzer	OTHER
sternentänzer	stern	tänzer	OTHER
stripteasetänzer	striptease	tänzer	OTHER
technotänzer	techno	tänzer	OTHER
thai-tänzer	thai	tänzer	OTHER
traumtänzer	traum	tänzer	DEROGATORY
turniertänzer	turnier	tänzer	OTHER
amateur-verbrecher	amateur	verbrecher	OTHER
befriedungsverbrecher	befriedung	verbrecher	OTHER
bolschewistenverbrecher	bolschewist	verbrecher	DEROGATORY
drogenverbrecher	droge	verbrecher	OTHER
jahrtausendverbrecher	jahrtausend	verbrecher	OTHER
justizverbrecher	justiz	verbrecher	OTHER
karriere-verbrecher	karriere	verbrecher	OTHER
mafia-verbrecher	mafia	verbrecher	OTHER
mikrowellenverbrecher	mikrowelle	verbrecher	OTHER
neigungsverbrecher	neigung	verbrecher	OTHER
punk-verbrecher	punk	verbrecher	OTHER
regierungsverbrecher	regierung	verbrecher	OTHER
regimeverbrecher	regime	verbrecher	OTHER
systemverbrecher	system	verbrecher	OTHER
triebverbrecher	trieb	verbrecher	OTHER
vertragsverbrecher	vertrag	verbrecher	OTHER
wehrmachtsverbrecher	wehrmacht	verbrecher	OTHER
wiederholungsverbrecher	wiederholung	verbrecher	OTHER
wirtschaftsverbrecher	wirtschaft	verbrecher	OTHER
zufallsverbrecher	zufall	verbrecher	OTHER
aktenverdreher	akt	verdreher	OTHER
augenverdreher	auge	verdreher	OTHER
buchstabenverdreher	buchstabe	verdreher	OTHER
formverdreher	form	verdreher	OTHER
gesetzesverdreher	gesetz	verdreher	DEROGATORY
hirnverdreher	hirn	verdreher	OTHER
inhaltsverdreher	inhalt	verdreher	DEROGATORY
interessenverdreher	interesse	verdreher	DEROGATORY
kartenverdreher	karte	verdreher	OTHER
kopfverdreher	kopf	verdreher	OTHER
realitätsverdreher	realität	verdreher	DEROGATORY
rechtsverdreher	recht	verdreher	DEROGATORY
satzverdreher	satz	verdreher	OTHER
sinnverdreher	sinn	verdreher	OTHER
tatsachenverdreher	tatsache	verdreher	DEROGATORY
uhrenverdreher	uhr	verdreher	OTHER
volksverdreher	volk	verdreher	DEROGATORY
wahrheitsverdreher	wahrheit	verdreher	DEROGATORY
zeitverdreher	zeit	verdreher	OTHER
zitat-verdreher	zitat	verdreher	OTHER
bestecher-verführer	bestecher	verführer	DEROGATORY
dirndlverführer	dirndl	verführer	OTHER
jugendverführer	jugend	verführer	OTHER
kinderverführer	kind	verführer	OTHER
kindesverführer	kind	verführer	OTHER
knabenverführer	knabe	verführer	DEROGATORY
kulturverführer	kultur	verführer	OTHER
luxus-verführer	luxus	verführer	OTHER
lyrikverführer	lyrik	verführer	OTHER
massenverführer	masse	verführer	DEROGATORY
meister-verführer	meister	verführer	OTHER
menschheitsverführer	menschheit	verführer	DEROGATORY
nachwuchsverführer	nachwuchs	verführer	OTHER
reichsverführer	reich	verführer	DEROGATORY
roman-verführer	roman	verführer	OTHER
serienverführer	serie	verführer	DEROGATORY
sängerverführer	sänger	verführer	OTHER
verbalverführer	verbal	verführer	OTHER
volksverführer	volk	verführer	DEROGATORY
witwenverführer	witwe	verführer	DEROGATORY
anhang-vergesser	anhang	vergesser	OTHER
hausaufgabenvergesser	hausaufgabe	vergesser	OTHER
impressumvergesser	impressum	vergesser	OTHER
namenvergesser	name	vergesser	OTHER
passwort-vergesser	passwort	vergesser	OTHER
pflanzenvergesser	pflanze	vergesser	OTHER
pillenvergesser	pille	vergesser	OTHER
regenschirm-vergesser	regenschirm	vergesser	OTHER
schlüssel-vergesser	schlüssel	vergesser	OTHER
schulterblick-vergesser	schulterblick	vergesser	OTHER
sorgenvergesser	sorge	vergesser	OTHER
teebeutelvergesser	teebeutel	vergesser	OTHER
terminvergesser	termin	vergesser	OTHER
textvergesser	text	vergesser	OTHER
turnbeutelvergesser	turnbeutel	vergesser	DEROGATORY
vesperbrotvergesser	vesperbrot	vergesser	OTHER
wort-vergesser	wort	vergesser	OTHER
zahnarztterminvergesser	zahnarzttermin	vergesser	OTHER
zeitvergesser	zeit	vergesser	OTHER
zitationsvergesser	zitation	vergesser	OTHER
bassvergewaltiger	bass	vergewaltiger	DEROGATORY
bauernvergewaltiger	bauer	vergewaltiger	OTHER
behinderten-vergewaltiger	behinderte	vergewaltiger	OTHER
ehefrauenvergewaltiger	ehefrau	vergewaltiger	OTHER
frauenvergewaltiger	frau	vergewaltiger	OTHER
gelegenheitsvergewaltiger	gelegenheit	vergewaltiger	OTHER
grasnarbenvergewaltiger	grasnarbe	vergewaltiger	DEROGATORY
hurenvergewaltiger	hure	vergewaltiger	OTHER
kindervergewaltiger	kind	vergewaltiger	OTHER
kindesvergewaltiger	kind	vergewaltiger	OTHER
krawattenvergewaltiger	krawatte	vergewaltiger	DEROGATORY
massenvergewaltiger	masse	vergewaltiger	OTHER
mikrofonvergewaltiger	mikrofon	vergewaltiger	DEROGATORY
rechtsvergewaltiger	recht	vergewaltiger	DEROGATORY
serienvergewaltiger	serie	vergewaltiger	OTHER
tonleitervergewaltiger	tonleiter	vergewaltiger	DEROGATORY
trommelfellvergewaltiger	trommelfell	vergewaltiger	DEROGATORY
völkerrechtsvergewaltiger	völkerrecht	vergewaltiger	DEROGATORY
wortvergewaltiger	wort	vergewaltiger	DEROGATORY
zelluloidvergewaltiger	zelluloid	vergewaltiger	DEROGATORY
atmosphäre-vergifter	atmosphäre	vergifter	DEROGATORY
brunnenvergifter	brunnen	vergifter	OTHER
fleischvergifter	fleisch	vergifter	OTHER
gedankenvergifter	gedanke	vergifter	DEROGATORY
gewebevergifter	gewebe	vergifter	OTHER
hoffnungsvergifter	hoffnung	vergifter	DEROGATORY
hundevergifter	hund	vergifter	OTHER
klimavergifter	klima	vergifter	DEROGATORY
lebensmittelvergifter	lebensmittel	vergifter	OTHER
lebensvergifter	leben	vergifter	DEROGATORY
nordsee-vergifter	nordsee	vergifter	OTHER
pferdevergifter	pferd	vergifter	OTHER
quellenvergifter	quelle	vergifter	OTHER
seelenvergifter	seele	vergifter	DEROGATORY
seniorenvergifter	senior	vergifter	OTHER
taubenvergifter	taube	vergifter	OTHER
tiervergifter	tier	vergifter	OTHER
umweltvergifter	umwelt	vergifter	DEROGATORY
wasservergifter	wasser	vergifter	OTHER
weltvergifter	welt	vergifter	OTHER
amerika-versteher	amerika	versteher	OTHER
bosnien-versteher	bosnien	versteher	OTHER
figurenversteher	figur	versteher	OTHER
fortuna-versteher	fortuna	versteher	OTHER
frauenversteher	frau	versteher	DEROGATORY
generationenversteher	generation	versteher	OTHER
gewalt-versteher	gewalt	versteher	OTHER
hundeversteher	hund	versteher	OTHER
islamistenversteher	islamist	versteher	DEROGATORY
islamversteher	islam	versteher	DEROGATORY
jugendversteher	jugend	versteher	OTHER
katzenversteher	katze	versteher	OTHER
kunstversteher	kunst	versteher	OTHER
menschenversteher	mensch	versteher	OTHER
musik-versteher	musik	versteher	OTHER
mädchenversteher	mädchen	versteher	DEROGATORY
schwestern-versteher	schwester	versteher	OTHER
spaßversteher	spaß	versteher	OTHER
täterversteher	täter	versteher	OTHER
weltversteher	welt	versteher	DEROGATORY
alimenteverweigerer	aliment	verweigerer	OTHER
angebotsverweigerer	angebot	verweigerer	OTHER
auskunftsverweigerer	auskunft	verweigerer	OTHER
auswechslungsverweigerer	auswechslung	verweigerer	OTHER
babyverweigerer	baby	verweigerer	OTHER
evolutionsverweigerer	evolution	verweigerer	OTHER
fortschrittsverweigerer	fortschritt	verweigerer	DEROGATORY
gewissensverweigerer	gewissen	verweigerer	OTHER
handyverweigerer	handy	verweigerer	DEROGATORY
informationsverweigerer	information	verweigerer	DEROGATORY
karnevalsverweigerer	karneval	verweigerer	OTHER
kriegsdienstverweigerer	kriegsdienst	verweigerer	OTHER
leistungsverweigerer	leistung	verweigerer	OTHER
milchverweigerer	milch	verweigerer	OTHER
portfolio-verweigerer	portfolio	verweigerer	OTHER
praxisverweigerer	praxis	verweigerer	OTHER
reformverweigerer	reform	verweigerer	OTHER
steuerverweigerer	steuer	verweigerer	OTHER
weihnachtsverweigerer	weihnacht	verweigerer	DEROGATORY
zivildienstverweigerer	zivildienst	verweigerer	OTHER
arbeitsvieh	arbeit	vieh	OTHER
borstenvieh	borste	vieh	OTHER
drecksvieh	dreck	vieh	DEROGATORY
gassenvieh	gasse	vieh	OTHER
herdenvieh	herd	vieh	OTHER
klatschvieh	klatsch	vieh	DEROGATORY
klauenvieh	klaue	vieh	OTHER
lastvieh	last	vieh	OTHER
milchvieh	milch	vieh	OTHER
nutzvieh	nutz	vieh	OTHER
panther-vieh	panther	vieh	OTHER
plastikvieh	plastik	vieh	OTHER
qualitätsvieh	qualität	vieh	OTHER
rattenvieh	ratte	vieh	OTHER
rindvieh	rind	vieh	OTHER
saisonvieh	saison	vieh	OTHER
schlachtvieh	schlacht	vieh	OTHER
vogelvieh	vogel	vieh	OTHER
weidevieh	weide	vieh	OTHER
zuchtvieh	zucht	vieh	OTHER
affenvisage	affe	visage	DEROGATORY
gedenkstättenvisage	gedenkstätte	visage	DEROGATORY
giftvisage	gift	visage	DEROGATORY
henkervisage	henker	visage	OTHER
hundevisage	hund	visage	OTHER
killervisage	killer	visage	OTHER
kohlvisage	kohl	visage	DEROGATORY
ledervisage	leder	visage	OTHER
maskenvisage	maske	visage	OTHER
monstervisage	monster	visage	OTHER
ochsenvisage	ochse	visage	DEROGATORY
plastik-visage	plastik	visage	OTHER
rabenvisage	rabe	visage	OTHER
reportervisage	reporter	visage	DEROGATORY
schlägervisage	schläger	visage	DEROGATORY
schreckensvisage	schrecken	visage	OTHER
tätervisage	täter	visage	OTHER
verbrechervisage	verbrecher	visage	DEROGATORY
verlierer-visage	verlierer	visage	DEROGATORY
zombievisage	zombie	visage	OTHER
dornvogel	dorn	vogel	OTHER
flammenvogel	flamme	vogel	OTHER
fliegenvogel	fliege	vogel	OTHER
gossenvogel	gosse	vogel	OTHER
grasvogel	gras	vogel	OTHER
käfigvogel	käfig	vogel	OTHER
königsvogel	könig	vogel	OTHER
laubenvogel	laube	vogel	OTHER
lustvogel	lust	vogel	DEROGATORY
papiervogel	papier	vogel	OTHER
qualitätsvogel	qualität	vogel	OTHER
raupenvogel	raupe	vogel	OTHER
schirmvogel	schirm	vogel	OTHER
seuchenvogel	seuche	vogel	DEROGATORY
sperlingsvogel	sperling	vogel	OTHER
strandvogel	strand	vogel	OTHER
tierschutzvogel	tierschutz	vogel	OTHER
unglücksvogel	unglück	vogel	OTHER
wattenmeer-vogel	wattenmeer	vogel	OTHER
wiesenvogel	wiese	vogel	OTHER
baumwachtel	baum	wachtel	OTHER
bratwachtel	brat	wachtel	OTHER
erdwachtel	erd	wachtel	OTHER
hauswachtel	haus	wachtel	OTHER
heidewachtel	heide	wachtel	OTHER
japanwachtel	japan	wachtel	OTHER
mastwachtel	mast	wachtel	OTHER
maulwurfswachtel	maulwurf	wachtel	OTHER
moralwachtel	moral	wachtel	DEROGATORY
ofenwachtel	ofen	wachtel	OTHER
schopfwachtel	schopf	wachtel	OTHER
spinatwachtel	spinat	wachtel	DEROGATORY
straußwachtel	strauß	wachtel	OTHER
sumpfwachtel	sumpf	wachtel	OTHER
virginiawachtel	virginia	wachtel	OTHER
waldwachtel	wald	wachtel	OTHER
wetterwachtel	wetter	wachtel	OTHER
zahnwachtel	zahn	wachtel	OTHER
zuchtwachtel	zucht	wachtel	OTHER
zwergwachtel	zwerg	wachtel	OTHER
babywalze	baby	walze	OTHER
bilderwalze	bild	walze	OTHER
crescendo-walze	crescendo	walze	OTHER
enigma-walze	enigma	walze	OTHER
grundwalze	grund	walze	OTHER
hagelwalze	hagel	walze	OTHER
kugelwalze	kugel	walze	OTHER
laubwalze	laub	walze	OTHER
laufwalze	lauf	walze	OTHER
messerwalze	messer	walze	OTHER
nadelwalze	nadel	walze	OTHER
programmwalze	programm	walze	OTHER
rasenwalze	rasen	walze	OTHER
rodewalze	roden	walze	OTHER
rouladenwalze	roulade	walze	OTHER
sackwalze	sack	walze	DEROGATORY
schlammwalze	schlamm	walze	OTHER
seilwalze	seil	walze	OTHER
wolkenwalze	wolke	walze	OTHER
zylinderwalze	zylinder	walze	OTHER
abstandswarner	abstand	warner	OTHER
auktions-warner	auktion	warner	OTHER
borgwarner	borg	warner	OTHER
dopingwarner	doping	warner	OTHER
ereigniswarner	ereignis	warner	OTHER
frostwarner	frost	warner	OTHER
gentechnologiewarner	gentechnologie	warner	DEROGATORY
klimawarner	klima	warner	OTHER
lawinenwarner	lawine	warner	OTHER
radarwarner	radar	warner	OTHER
rauchwarner	rauch	warner	OTHER
reifendruckwarner	reifendruck	warner	OTHER
schlüsselwarner	schlüssel	warner	OTHER
sektenwarner	sekte	warner	DEROGATORY
speicherwarner	speicher	warner	OTHER
stall-warner	stall	warner	OTHER
umweltwarner	umwelt	warner	DEROGATORY
virus-warner	virus	warner	OTHER
wildwarner	wild	warner	OTHER
ölstandswarner	ölstand	warner	OTHER
abschiedswinker	abschied	winker	DEROGATORY
abstrahlwinker	abstrahl	winker	OTHER
aufbauwinker	aufbau	winker	OTHER
autowinker	auto	winker	OTHER
baustellenwinker	baustelle	winker	OTHER
begrüßungswinker	begrüßung	winker	OTHER
brückenwinker	brücke	winker	OTHER
deckswinker	deck	winker	OTHER
fahnenwinker	fahne	winker	OTHER
fähnchenwinker	fähnchen	winker	OTHER
handwinker	hand	winker	OTHER
herrenwinker	herr	winker	OTHER
kamerawinker	kamera	winker	OTHER
klappwinker	klappen	winker	OTHER
linienwinker	linie	winker	OTHER
mastwinker	mast	winker	OTHER
pendelwinker	pendel	winker	OTHER
signalwinker	signal	winker	OTHER
stammwinker	stamm	winker	OTHER
zaunpfahlwinker	zaunpfahl	winker	OTHER
augenwischer	auge	wischer	DEROGATORY
beifahrerwischer	beifahrer	wischer	OTHER
fensterwischer	fenster	wischer	OTHER
fußbodenwischer	fußboden	wischer	OTHER
gedanken-wischer	gedanke	wischer	OTHER
gummiwischer	gummi	wischer	OTHER
handwischer	hand	wischer	OTHER
heckscheibenwischer	heckscheibe	wischer	OTHER
hinternwischer	hintern	wischer	DEROGATORY
hongkong-wischer	hongkong	wischer	OTHER
intervallwischer	intervall	wischer	OTHER
kanonenwischer	kanone	wischer	OTHER
otterwischer	otter	wischer	OTHER
pinselwischer	pinsel	wischer	OTHER
regenwischer	regen	wischer	OTHER
rohrwischer	rohr	wischer	OTHER
rückfallwischer	rückfall	wischer	OTHER
scheinwerferwischer	scheinwerfer	wischer	OTHER
tafelwischer	tafel	wischer	OTHER
tintenwischer	tinte	wischer	OTHER
bahnzähler	bahn	zähler	OTHER
besucher-zähler	besucher	zähler	OTHER
erbsenzähler	erbse	zähler	DEROGATORY
fahrzeugzähler	fahrzeug	zähler	OTHER
infektionszähler	infektion	zähler	OTHER
inselzähler	insel	zähler	OTHER
kilometer-zähler	kilometer	zähler	OTHER
kostenzähler	kosten	zähler	OTHER
nationalitätenzähler	nationalität	zähler	OTHER
passagierzähler	passagier	zähler	OTHER
pendelzähler	pendel	zähler	OTHER
schrittzähler	schritt	zähler	OTHER
spitzenzähler	spitze	zähler	OTHER
stromproduktions-zähler	stromproduktion	zähler	OTHER
telefonzähler	telefon	zähler	OTHER
verbrauchszähler	verbrauch	zähler	OTHER
vogelzähler	vogel	zähler	OTHER
volkszähler	volk	zähler	OTHER
wärmezähler	wärme	zähler	OTHER
zugriffszähler	zugriff	zähler	OTHER
dauerüberholer	dauer	überholer	DEROGATORY
ehren-überholer	ehre	überholer	OTHER
fahrwerksüberholer	fahrwerk	überholer	OTHER
flugzeugüberholer	flugzeug	überholer	OTHER
geisterfahrerüberholer	geisterfahrer	überholer	DEROGATORY
getriebeüberholer	getriebe	überholer	OTHER
innerorts-überholer	innerort	überholer	DEROGATORY
kamikazeüberholer	kamikaze	überholer	DEROGATORY
kolonnen-überholer	kolonne	überholer	OTHER
lichtmaschinenüberholer	lichtmaschine	überholer	OTHER
lkw-überholer	lkw	überholer	OTHER
motorüberholer	motor	überholer	OTHER
phantom-überholer	phantom	überholer	OTHER
profigetriebeüberholer	profigetriebe	überholer	OTHER
standspurüberholer	standspur	überholer	DEROGATORY
standstreifenüberholer	standstreifen	überholer	DEROGATORY
stauüberholer	stau	überholer	DEROGATORY
turboüberholer	turbo	überholer	OTHER
vettelüberholer	vettel	überholer	OTHER
zielkanalüberholer	zielkanal	überholer	OTHER
